iduka	idu/ka
baldit͡ʃaːw	baldi/t͡ʃaː/w
aha	aha
ďuwun	ďu/wun
həgdiŋə	həgdiŋə
əɲijo	əɲi/jo
ribat͡ʃitt͡ʃəŋkiːtin	ribat͡ʃit/t͡ʃə/ŋkiː/tin
ďuγaɲiːwa	ďuγa/ɲiː/wa
ďuγaɲiːduː	ďuγa/ɲiː/duː
nulgiďəŋkiːwun	nulgi/ďə/ŋkiː/wun
əŋkiːwun	ə/ŋkiː/wun
təγəttə	təγə/t/tə
antimati	anti/mati
kuŋakarduːwun	kuŋaka/r/duː/wun
ajakanďi	aja/kan/ďi
oldolwə	oldo/l/wə
hilkiďiŋnərəwun	hilki/ďi/ŋnə/rə/wun
adilt͡ʃuhiniŋnərəwun	adil/t͡ʃu/hini/ŋnə/rə/wun
aďililwə	aďili/l/wə
towuďət͡ʃoːtin	towu/ďə/t͡ʃoː/tin
toːwər	toː/wər
igo	igo
əliː	ə/liː
kilometrduliː	kilometr/duliː
ŋənəŋnərəwun	ŋənə/ŋnə/rə/wun
oldolə	oldo/l/ə
iruŋnarawun	iru/ŋna/ra/wun
əkurďikə	əku/r/ďi/kə
hutakarduː	huta/ka/r/duː
uγaďəŋnarawun	uγa/ďə/ŋna/ra/wun
oldokorwə	oldo/ko/r/wə
wot	wot
biŋkiːn	bi/ŋkiː/n
ələwun	ələ/wun
planmutin	plan/mu/tin
vipalɲatt͡ʃiŋnərəwun	vipalɲat/t͡ʃi/ŋnə/rə/wun
oďəŋnərəwun	o/ďə/ŋnə/rə/wun
amiːja	amiː/ja
oďapkiːl	o/ďa/pkiː/l
bu	bu
dundəwə	dundə/wə
ďuguďiŋnərəwun	ďugu/ďi/ŋnə/rə/wun
ďawu	ďawu
ďawut͡ʃaďat͡ʃaːwun	ďawut͡ʃa/ďa/t͡ʃaː/wun
əjaka	ə/ja/ka
hamɲiːkarə	hamɲiː/ka/r/ə
oŋnərəwun	o/ŋnə/rə/wun
hamɲiːro	hamɲiː/r/o
əwa	ə/wa
gunďərə	gun/ďə/rə
se	se
internattulaː	internat/tulaː
gənnoːpkiːl	gənnoː/pkiː/l
ut͡ʃitnaːŋnərəwun	ut͡ʃit/naː/ŋnə/rə/wun
tigdəďərəkin	tigdə/ďə/rəki/n
ďukakanə	ďu/kakan/ə
oďarəwun	o/ďa/rə/wun
nulgit	nulgi/t
əŋkiːtin	ə/ŋkiː/tin
sobirarə	sobira/rə
inďərən	in/ďə/rə/n
ətiːrkot͡ʃomi	ətiːrko/t͡ʃo/mi
jaŋəti	jaŋəti
danila	danila
nikalajəvit͡ʃ	nikalajəvit͡ʃ
strogij	strogij
biŋkiːntə	bi/ŋkiː/n/tə
ďawut͡ʃaďaŋkiːn	ďawut͡ʃa/ďa/ŋkiː/n
huruŋnərəwun	huru/ŋnə/rə/wun
goroʃihalaː	goroʃiha/laː
toʒə	toʒə
kanikulilwun	kanikuli/l/wun
biŋkiːtin	bi/ŋkiː/tin
wəkitta	wəki/t/ta
inďət͡ʃoːw	in/ďə/t͡ʃoː/w
hawalilt͡ʃalai	hawali/l/t͡ʃala/i
inihit͡ʃoːw	ini/hi/t͡ʃoː/w
turalaː	tura/laː
ut͡ʃitnaːhit͡ʃoːw	ut͡ʃit/naː/hi/t͡ʃoː/w
manamda	mana/m/da
hawalim	hawali/m
tapat͡ʃa	tapat͡ʃa
tapat͡ʃaːtil	tapat͡ʃaːti/l
jaːdantsəwil	jaːdantsəwi/l
munŋi	mun/ŋi
haːdont͡ʃinil	haːdont͡ʃini/l
təγəm	təγə/m
ami	ami
soloːki	soloːki
turaːmiwa	turaːmi/wa
ollolo	ollo/l/o
kətəkoːkuːnmə	kətə/koːkuːn/mə
waːrəw	waː/rə/w
amiːnən	amiː/nən
aːgrəw	aːg/rə/w
aːsinmurən	aː/sin/mu/rə/n
tirgallan	tirga/l/la/n
gowolt͡ʃol	gowo/l/t͡ʃo/l
iːduwəl	iːdu/wəl
arakuːkan	ara/kuːkan
təγət͡ʃon	təγə/t͡ʃo/n
səriːwrə	səriː/w/rə
surut͡ʃo	suru/t͡ʃo
ŋinakirwə	ŋinaki/r/wə
gowoďərilwo	gowo/ďə/ri/l/wo
waːnaːstən	waː/naː/s/tə/n
it͡ʃenoːst͡ʃo	it͡ʃe/noː/s/t͡ʃo
eːkurwa	eːku/r/wa
gowoďoro	gowo/ďo/ro
dilat͡ʃ	dilat͡ʃ
hətəkənəm	hətəkənə/m
dilat͡ʃa	dilat͡ʃa
ďo	ďo
aŋiďərən	aŋi/ďə/rə/n
suruďəm	suru/ďə/m
gowondulaːtin	gowo/n/dulaː/tin
surum	suru/m
kuktim	kukti/m
pəktironmə	pəktiron/mə
buːh	buːh
pəktiron	pəktiron
gowoďəmi	gowo/ďə/mi
wras	wras
tajgato	tajga/to
tihə	tihə
əwuːst͡ʃam	əwuː/s/t͡ʃa/m
urə	urə
hoktowi	hokto/wi
sokorim	sokori/m
uďalaːwi	uďa/laː/wi
əmədoːwi	əmə/doː/wi
aŋilaːwi	aŋi/laː/wi
bit͡ʃoːw	bi/t͡ʃoː/w
doːldiːra	doːldiː/ra
taigaduː	taiga/duː
damka	damka
gərbiwi	gərbi/wi
saːnə	saː/nə
haːŋiďaďan	haːŋi/ďa/ďa/n
amiːŋasaw	amiː/ŋasa/w
ŋənəďəďən	ŋənə/ďə/ďə/n
ŋinakinmiː	ŋinakin/miː
uďalwaw	uďa/l/wa/w
bakaran	baka/ra/n
uďalduliːw	uďa/l/duliː/w
iːloː	iːloː
ŋənəďənnə	ŋənə/ďə/nnə
sinə	sinə
pəktironməs	pəktiron/mə/s
doːldiːt͡ʃaw	doːldiː/t͡ʃa/w
həŋkəttən	həŋkət/tə/n
surunnə	suru/nnə
alatt͡ʃet͡ʃa	alat/t͡ʃe/t͡ʃa
bimt͡ʃes	bi/mt͡ʃe/s
əmərəw	əmə/rə/w
buː	buː
guluwundulaːwər	guluwun/dulaː/wər
sawoːdalwər	sawoːda/l/wər
moːtiːwə	moːtiː/wə
waːmi	waː/mi
higďərə	hig/ďə/rə
taːnisinən	taːni/sin/ə/n
bisin	bi/si/n
tigəkoːrwis	tigə/koː/r/wi/s
aŋikəl	aŋi/kəl
moːtiːt	moːtiːt
aŋit͡ʃa	aŋi/t͡ʃa
əta	əta
uloːkkirən	uloːkki/rə/n
ďuːduːwar	ďuː/duː/war
uliďəďet	uli/ďə/ďe/t
ut͡ʃalaːďet	ut͡ʃalaː/ďe/t
arakuːkaːn	ara/kuːkaːn
ədaːw	ə/daː/w
it͡ʃərə	it͡ʃə/rə
purtatpi	purta/t/pi
ərkoːnduliː	ər/koːn/duliː
aŋirən	aŋi/rə/n
arkirən	arki/rə/n
moːtiːtkoːn	moːtiː/t/koːn
kikisinən	kiki/sin/ə/n
ol	ol
ulləŋilwər	ullə/ŋi/l/wər
ďuwurəw	ďuwu/rə/w
ďawdulaːwər	ďaw/dulaː/wər
halwatin	ha/l/wa/tin
omoːnəw	omoːn/ə/w
maleɲka	maleɲka
suʃiť	suʃiť
tagda	tagda
sə	sə
ďawduːwər	ďaw/duː/wər
ulləkoːrwə	ullə/koː/r/wə
noːttəw	noː/t/tə/w
fśe	fśe
aŋilaːwər	aŋi/laː/wər
klastuː	klas/tuː
ut͡ʃenikilwiː	ut͡ʃeniki/l/wiː
tunŋa	tunŋa
ət͡ʃoːtin	ə/t͡ʃoː/tin
kət	kət
kətəkoːkun	kətə/koːkun
śergejif	śergejif
familijən	familijə/n
sergejew	sergejew
gərbiːn	gərbiː/n
trəfim	trəfim
manarən	mana/rə/n
klaswa	klas/wa
staːdolaː	staːdo/laː
sururən	suru/rə/n
orordi	oro/r/di
amtiːldulaːwi	amtiːl/dulaː/wi
əhiːkoːn	əhiː/koːn
staːdoduk	staːdo/duk
əməwusinə	əmə/wu/sin/ə
kuŋaːkaːrwə	kuŋaːkaː/r/wə
nor	nor
əlaː	ə/laː
əwədit	əwə/di/t
nuŋanduːn	nuŋan/duː/n
aŋila	aŋi/l/a
tug	tug
əɲininnə	əɲini/n/nə
əɲinin	əɲini/n
əːkəː	əː/kəː
oːn	oːn
ut͡ʃiťelɲitsa	ut͡ʃiťelɲitsa
grit	grit
gərbin	gərbi/n
familjawan	familja/wa/n
omŋom	omŋo/m
əɲimtiki	əɲi/m/tiki
aŋikaːnə	aŋi/kaːn/ə
ɲaŋtatiːďam	ɲaŋta/tiː/ďa/m
nuŋandulaːn	nuŋan/dulaː/n
padaːrəkjəwi	padaːrək/jə/wi
əːjawiw	əː/ja/wi/w
suru	suru
ut͡ʃiťelɲitsaduːwi	ut͡ʃiťelɲitsa/duː/wi
nuŋaŋilin	nuŋa/ŋi/li/n
trofimŋil	trofim/ŋi/l
ďajaďan	ďaja/ďa/n
miʃokpi	miʃok/pi
bakaďara	baka/ďa/ra
əɲi	əɲi
niːkə	niː/kə
ɲaŋtaŋilwəm	ɲaŋta/ŋi/l/wə/m
aŋiďan	aŋi/ďa/n
ďajakal	ďaja/kal
ədoːtin	ə/doː/tin
bakara	baka/ra
patəjil	patəji/l
klastuːi	klas/tuː/i
təγətt͡ʃəm	təγə/t/t͡ʃə/m
trafim	trafim
ut͡ʃeɲikiw	ut͡ʃeɲiki/w
zdraːstwujťe	zdraːstwujťe
aŋiwi	aŋi/wi
karmandukpi	karman/duk/pi
aŋiran	aŋi/ra/n
əːdukpiwəl	əːduk/pi/wəl
aŋikaːnmə	aŋi/kaːn/mə
ərdikoːnmə	ərdi/koːn/mə
t͡ʃemokokoːn	t͡ʃemo/kokoːn
ɲaŋtal	ɲaŋta/l
t͡ʃenokoːnkə	t͡ʃeno/koːn/kə
ɲaŋɲa	ɲaŋɲa
upkat͡ʃin	upkat͡ʃi/n
ɲaŋɲaja	ɲaŋɲa/ja
əbəj	əbəj
ďepďerə	ďep/ďe/rə
adiːraːdaː	adiː/raː/daː
ďajan	ďaja/n
əsile	əsile
sinduː	sin/duː
əməwum	əmə/wu/m
bun	bun
tuktə	tuk/tə
guďeːj	guďeːj
nəlki	nəlki
baldit͡ʃam	baldi/t͡ʃa/m
balnitsa	balnitsa
baldit͡ʃaːm	baldi/t͡ʃaː/m
duːkuďat͡ʃaːtin	duːku/ďa/t͡ʃaː/tin
ďapkundulaː	ďapkun/dulaː
klasəldulaː	klasə/l/dulaː
ɲuŋunduː	ɲuŋun/duː
surut͡ʃoːm	suru/t͡ʃoː/m
əməm	əmə/m
hawalilim	hawali/li/m
śit͡ʃastə	śit͡ʃas/tə
aːt͡ʃir	aːt͡ʃi/r
məːrwəl	məːr/wəl
aŋirə	aŋi/rə
dapdarə	dapda/rə
ʃas	ʃas
orirə	ori/rə
amija	ami/ja
nado	nado
onmər	on/mər
ɲəkəmi	ɲəkə/mi
ətəjəːtnoːmi	ətəjəː/t/noː/mi
ladno	ladno
vet͡ʃərəm	vet͡ʃərəm
əməďim	əmə/ďi/m
ďirikat͡ʃaːn	ďirika/t͡ʃaːn
əːkundaː	əːkun/daː
iːduː	iːduː
t͡ʃikilmi	t͡ʃikil/mi
ətəjəːtmi	ətəjəː/t/mi
paka	paka
horolďit͡ʃoːwun	horol/ďi/t͡ʃoː/wun
ulgut͡ʃoːmott͡ʃit͡ʃoːwun	ulgut͡ʃoː/mot/t͡ʃi/t͡ʃoː/wun
it͡ʃərəwunduː	it͡ʃə/rə/wun/duː
tawarka	ta/war/ka
uʒe	uʒe
uʃ	uʃ
loporoːrən	loporoː/rə/n
ďirikaltuk	ďirika/l/tuk
əməldəkin	əmə/ldək/in
əduk	əduk
it͡ʃəwun	it͡ʃə/wun
oːďan	oː/ďa/n
loporoːrakin	loporoː/rak/in
ŋəpkəkəːlaː	ŋəpkəkəː/laː
təpkəhinďəm	təpkə/hin/ďə/m
gojoːwlipt͡ʃə	gojoːwli/p/t͡ʃə
ŋəpkəkəːləː	ŋəpkəkəː/ləː
omoːnəwun	omoːn/ə/wun
haŋkəlwun	haŋkə/l/wun
biďit͡ʃəːtin	bi/ďi/t͡ʃəː/tin
ďuːlduː	ďuː/l/duː
ujuːt͡ʃəjit͡ʃəːtin	ujuː/t͡ʃə/ji/t͡ʃəː/tin
haŋkəlwər	haŋkə/l/wər
gənnoːrəwun	gənnoː/rə/wun
haŋkəlďi	haŋkə/l/ďi
ŋinaγiːrawun	ŋinaγiː/ra/wun
uːďaliːn	uːďa/liː/n
ŋinaki	ŋinaki
znat͡ʃit	znat͡ʃit
ďawaran	ďawa/ra/n
geːtəː	geː/təː
ŋoːləlt͡ʃə	ŋoːlə/l/t͡ʃə
geː	geː
goγoďəkoːrən	goγo/ďə/koː/rə/n
it͡ʃə	it͡ʃə
it͡ʃərəwun	it͡ʃə/rə/wun
təːr	təːr
aːmutkaːn	aːmut/kaːn
bargiːγiďin	bargiː/γiďi/n
aːŋďərən	aːŋ/ďə/rə/n
bəjiːtt͡ʃərən	bəjiː/t/t͡ʃə/rə/n
pəktirəːnim	pəktirəːni/m
məlt͡ʃoːt͡ʃə	məlt͡ʃoː/t͡ʃə
iːkəːriːwon	iːkəːriː/wo/n
tariŋiːwun	tari/ŋiː/wun
muːloː	muː/loː
oːŋkaːnən	oːŋkaːn/ə/n
bururən	buru/rə/n
ďetŋoγow	ďet/ŋoγo/w
pətkət	pətkət
tozowkatpi	tozowka/t/pi
dilmaːliːn	dil/maː/liː/n
pəktiroːnən	pəktiroːn/ə/n
naːpkaːnən	naː/p/kaː/nə/n
əjəːďənnə	əjəː/ďə/n/nə
muːduː	muː/duː
guɲďərən	guɲ/ďə/rə/n
əjəːpkiː	əjəː/pkiː
iɲďərən	iɲ/ďə/rə/n
tihaktaďərən	tiha/kta/ďə/rə/n
ďawaďəndə	ďawa/ďə/ndə
aramaː	aramaː
nuŋənməːn	nuŋənməːn
urihinəwun	uri/hin/ə/wun
taːduːdaː	taːduː/daː
əːt͡ʃaːwunkə	əː/t͡ʃaː/wun/kə
luktawundaː	luk/ta/wun/daː
nuŋəməːn	nuŋəməːn
təlgətnəl	təlgə/t/nə/l
gadawun	ga/da/wun
hiːwon	hiː/wo/n
gat͡ʃaːwun	ga/t͡ʃaː/wun
tukdoː	tuk/doː
bimnin	bimnin
ej	ej
uldəwən	uldə/wə/n
ət͡ʃəːwun	ə/t͡ʃəː/wun
gadə	ga/də
biďən	bi/ďə/n
amiː	amiː
təruːttan	təruːt/ta/n
əmonmut͡ʃoːtin	əmon/mu/t͡ʃoː/tin
ďuːduː	ďuː/duː
uďaltin	uďa/l/tin
guləlduː	gulə/l/duː
tam	tam
oːkiː	oːkiː
tri	tri
ilaldawa	ila/lda/wa
wirtolotit	wirtoloti/t
dəγirəwun	dəγi/rə/wun
ďuːduːwər	ďuː/duː/wər
ŋinakinmi	ŋinakin/mi
hukuləː	hukuləː
əji	əji
hata	hata
gunďəm	gun/ďə/m
wirtolottulaː	wirtolot/tulaː
ədaːji	ə/daː/ji
it͡ʃətnoːm	it͡ʃə/t/noː/m
əwanda	ə/wa/n/da
ət͡ʃəːw	ə/t͡ʃəː/w
it͡ʃəttə	it͡ʃə/t/tə
kikirkal	kiki/rka/l
kujiːkoːtt͡ʃənəl	kujiː/koːt/t͡ʃə/nə/l
dolboltono	dolboltono
it͡ʃətt͡ʃilim	it͡ʃə/t/t͡ʃi/li/m
hagditmər	hagdi/tmər
biďirən	bi/ďi/rə/n
giːl	giː/l
gunəm	gunə/m
biďənorə	bi/ďə/no/rə
goʃaja=	goʃa/ja=
biďit͡ʃoːtin	bi/ďi/t͡ʃoː/tin
əh	əh
kak	kak
ratsijaliː	ratsija/liː
hanŋuːktam	hanŋuːkta/m
boγ	boγ
ďapkaliːn	ďapka/liː/n
it͡ʃəm	it͡ʃə/m
wolka	wolka
uďalin	uďa/li/n
wizďə	wizďə
t͡ʃaːγit	t͡ʃaː/γit
ďapkaliː	ďapka/liː
t͡ʃaːskiː	t͡ʃaːskiː
tariγit	tari/γit
girkut͡ʃa	girku/t͡ʃa
ŋinakirwi	ŋinaki/r/wi
at͡ʃir	at͡ʃi/r
t͡ʃipkaːn	t͡ʃipkaːn
warkə	wa/rkə
ďəwurkəlti	ďəwu/rkə/lti
iloː	iloː
oďərə	o/ďə/rə
amaːkaː	amaːkaː
eːkuninkək	eːkuni/n/kək
lapən	lapə/n
jaʃaja	jaʃa/ja
t͡ʃoknatin	t͡ʃok/na/tin
biʃo	bi/ʃo
orolo	orolo
oromilowun	oro/mi/l/o/wun
tirəmtit͡ʃo	tirə/mti/t͡ʃo
pau	pau
ət͡ʃol	ə/t͡ʃo/l
bihiwun	bi/hi/wun
pəktiroːwunmə	pəktiroː/wun/mə
gat͡ʃal	ga/t͡ʃa/l
pəktiroːwun	pəktiroː/wun
ganal	ga/na/l
hurut͡ʃol	huru/t͡ʃo/l
toːliː	toːliː
mut͡ʃuďəraktin	mut͡ʃu/ďə/rak/tin
ərə	ərə
uďaduːtin	uďa/duː/tin
ihit͡ʃakə	ihi/t͡ʃa/kə
hukuγit͡ʃo	huku/γi/t͡ʃo
nuŋariγitin	nuŋari/γi/tin
dinŋiːləːγit͡ʃo	dinŋiːləː/γi/t͡ʃo
təpkəďənə	təpkə/ďə/nə
dinŋiːləːhint͡ʃit͡ʃo	dinŋiːləː/hin/t͡ʃi/t͡ʃo
maril	mari/l
jaktaliː	jakta/liː
dinŋiːləːt͡ʃo	dinŋiːləː/t͡ʃo
aŋti	aŋti
meːwuːjit͡ʃa	meːwuː/ji/t͡ʃa
bəjunmə	bəjun/mə
əton	ə/to/n
pəktiroːrə	pəktiroː/rə
padrat	padrat
amaːkaːwə	amaːkaː/wə
t͡ʃoktaw	t͡ʃok/ta/w
irəmoːďit͡ʃəːw	irəmoː/ďi/t͡ʃəː/w
taːlaːkə	taːlaː/kə
ar	ar
art͡ʃəmkat͡ʃal	art͡ʃəmka/t͡ʃa/l
əːduk	əːduk
telegrammawə	telegramma/wə
buːt͡ʃəːwun	buː/t͡ʃəː/wun
art͡ʃəmkadaːtin	art͡ʃəmka/daː/tin
telegrammuwə	telegrammu/wə
bakat͡ʃal	baka/t͡ʃa/l
pətoːm	pətoːm
wuse	wuse
uʃli	uʃli
kəgda	kəgda
uʒ	uʒ
davno	davno
hawalit͡ʃalaːwun	hawali/t͡ʃalaː/wun
art͡ʃəmkat͡ʃaldəː	art͡ʃəmka/t͡ʃa/l/dəː
hajaːlə	hajaːlə
amandiːt͡ʃal	amandiː/t͡ʃa/l
staːdəwətin	staːdə/wə/tin
dariːliː	dariː/liː
ŋənət͡ʃo	ŋənə/t͡ʃo
bəγəːm	bə/γəː/m
dariːləː	dariː/ləː
ďuːtaːďət͡ʃəːl	ďuː/taː/ďə/t͡ʃəː/l
amarduliːwun	amar/duliː/wun
ahat͡ʃa	aha/t͡ʃa
brigaďiritin	brigaďiri/tin
hoːjduk	hoːj/duk
mut͡ʃuːt͡ʃa	mut͡ʃuː/t͡ʃa
uďaliːn	uďa/liː/n
tajmeɲ	tajmeɲ
ďapkaduːn	ďapka/duː/n
urinərəwun	urinə/rə/wun
art͡ʃarəwun	art͡ʃa/rə/wun
timaːnəktawan	timaːnə/ktawa/n
huktəhinəw	huktə/hinə/w
art͡ʃərəwun	art͡ʃə/rə/wun
haːlwətin	haː/l/wə/tin
taγim	taγi/m
znəkomijilbi	znəkomiji/l/bi
ďuːliːwun	ďuː/liː/wun
ŋənərə	ŋənə/rə
haruːkkar	haruːk/ka/r
huktiwuhijnə	huktiwu/hijn/ə
tarjaːkaklaː	tarjaːka/klaː
ororwətin	oro/r/wə/tin
taŋnaːhiːt͡ʃal	taŋ/naː/hiː/t͡ʃa/l
bit͡ʃoːl	bi/t͡ʃoː/l
taːduktaː	taːduk/taː
girkujit͡ʃaːwun	girku/ji/t͡ʃaː/wun
ďuːlduːtin	ďuː/l/duː/tin
balokilduːtin	baloki/l/duː/tin
ďuːkakaːnďiwər	ďuː/kakaːn/ďi/wər
irəmiːďət͡ʃoːwun	irəmiː/ďə/t͡ʃoː/wun
vtəroj	vtəroj
pervij	pervij
tarilduk	tari/l/duk
girkuďəŋnərəwun	girku/ďə/ŋnə/rə/wun
gorokoːnmə	goro/koːn/mə
tarγit	tar/γit
alikjə	alik/jə
ďiːγit	ďiːγit
ororďi	oro/r/ďi
umuːkoːnduː	umuːkoːn/duː
hurut͡ʃoːwun	huru/t͡ʃoː/wun
tartikiː	tar/tikiː
alik	alik
staːdəlaː	staːdə/laː
staːdəlaːtin	staːdə/laː/tin
nulgiːt͡ʃoːwun	nulgiː/t͡ʃoː/wun
nul	nul
nulgiːt͡ʃoːwuntə	nulgiː/t͡ʃoː/wun/tə
tsəlij	tsəlij
nulgiːw	nulgiː/w
itikirwiː	itiki/r/wiː
ŋənəwumdək	ŋənə/wu/mdək
taːduktə	taːduk/tə
hujett͡ʃoːwun	hujet/t͡ʃoː/wun
əməhit͡ʃoːwun	əmə/hi/t͡ʃoː/wun
ɲaːdiməːt͡ʃaːwun	ɲaːdiməː/t͡ʃaː/wun
orokoːrwə	oro/koː/r/wə
gďətə	gďətə
ďapkutalwaːγint͡ʃə	ďapkutal/waː/γint͡ʃə
əśo	əśo
gniluski	gniluski
dla	dla
dimokura	dimokura
tut	tut
dimokur	dimokur
oleɲam	oleɲam
taskajem	taskajem
iʃo	iʃo
dolboltənə	dolboltənə
ďəbdəːtin	ďəb/dəː/tin
oːŋnam	oː/ŋna/m
ʃtop	ʃtop
dolbo	dolbo
ďəbďədoːtin	ďəb/ďə/doː/tin
hutəldujiː	hutə/l/du/jiː
ďuːduːji	ďuː/duː/ji
hilkiːďəŋnəm	hilkiː/ďə/ŋnə/m
ďəbdoːjə	ďəb/doː/jə
vəri	vəri
uloːďəŋnəm	uloː/ďə/ŋnə/m
oːhakaːri	oːha/kaː/r/i
ut͡ʃuďəŋnəm	u/t͡ʃu/ďə/ŋnə/m
ubirajďiŋnəm	ubiraj/ďi/ŋnə/m
ətirkoːn	ətirkoːn
haŋkələjə	haŋkə/lə/jə
oːďapkiː	oː/ďa/pkiː
vot	vot
saməj	saməj
rəzgar	rəzgar
rəboti	rəboti
əleɲi	əleɲi
ubiga	ubiga
tuksaďipkiːl	tuksa/ďi/pkiː/l
palatkaldi	palatka/l/di
inďəŋnərəwun	in/ďə/ŋnə/rə/wun
palatkəl	palatkə/l
prije	prije
nulgiːŋnərəwun	nulgiː/ŋnə/rə/wun
kurəleśim	kurəleśim
jedim	jedim
ŋənəďəŋnərəwun	ŋənə/ďə/ŋnə/rə/wun
kəpkanilwəl	kəpkani/l/wəl
tawuŋnərə	tawu/ŋnə/rə
oldolo	oldo/l/o
waːďəpkiːl	waː/ďə/pkiː/l
rejsəjə	rejsə/jə
waːŋnərəwun	waː/ŋnə/rə/wun
virtəlotjə	virtəlot/jə
zəkəzaŋnərəwun	zəkəza/ŋnə/rə/wun
prəduktələ	prəduktə/l/ə
huruwupkiːl	huru/wu/pkiː/l
iz	iz
bərasti	bərasti
ďəlali	ďəlali
bərəsťa	bərəsťa
beresten	bereste/n
təːduk	təːduk
oːmnərə	oː/mnə/rə
əːttə	əːt/tə
medl	medl
pəruski	pəruski
iɲitt͡ʃət͡ʃoːwun	iɲ/it/t͡ʃə/t͡ʃoː/wun
letəʒə	letə/ʒə
oːŋmarkə	oːŋ/mar/kə
ətets	ətets
kəkojtə	kəkojtə
bəlezɲ	bəlezɲ
zəxvətili	zəxvətili
pləhoj	pləhoj
uruːpt͡ʃut	uruːpt͡ʃu/t
bussəďit͡ʃoːwun	bussə/ďi/t͡ʃoː/wun
kojəkak	kojəkak
viʒəli	viʒəli
u	u
kovo	kovo
deneg	deneg
jest	jest
brali	brali
ʃoto	ʃoto
raskazutə	raskazutə
wekittə	wek/it/tə
prəmhos	prəmhos
əhiː	əhiː
kəkoj	kəkoj
səfhos	səfhos
li	li
l	l
letə	letə
kək	kək
osiɲ	osiɲ
boliniː	boliniː
oːdənda	oː/də/n/da
ulumiːďədəːs	ulumiː/ďə/dəː/s
ətprəvlali	ətprəvlali
t͡ʃistəj	t͡ʃistəj
tundrəlaː	tundrə/laː
uŋŋnərə	uŋ/ŋnə/rə
nulgiːhinəŋnərəwun	nulgiː/hinə/ŋnə/rə/wun
tartəːki	tartəːki
laːŋilwər	laːŋ/il/wər
aŋənahinəŋnərəwun	aŋə/na/hinə/ŋnə/rə/wun
əʃo	əʃo
raskaʒu	raskaʒu
hutəlwər	hutə/l/wər
iːrgirəwuntə	iːrgi/rə/wun/tə
t͡ʃistij	t͡ʃistij
tundəraduː	tundəra/duː
əduːka	əduː/ka
tər	tər
moːγaduː	moːγa/duː
əŋkitin	ə/ŋki/tin
buːrə	buː/rə
saďiktuː	saďik/tuː
daʒə	daʒə
deɲgi	deɲgi
rebitiʃək	rebitiʃək
ne	ne
videlali	videlali
virəsli	virəsli
pərniʃkə	pərniʃkə
hərəso	hərəso
ut͡ʃilśə	ut͡ʃilśə
s	s
nim	nim
nuŋənduːn	nuŋənduːn
kamaγaː	kamaγaː
əduːwəl	ə/duː/wəl
əmərədə	əmə/rə/də
ďuːduːwərnə	ďuː/duː/wər/nə
prəmhosduː	prəmhos/duː
skolkə	skolkə
hodi	hodi
eti	eti
stroili	stroili
ʒe	ʒe
gruʒili	gruʒili
əməśoːtin	əmə/śoː/tin
ajat	ajat
lərok	lərok
nit͡ʃəvo	nit͡ʃəvo
netu	netu
prəduktə	prəduktə
taʃim	taʃim
prəduktələwər	prəduktə/l/ə/wər
uguːgərəw	uguː/gə/rə/w
bit͡ʃəvoj	bit͡ʃəvoj
təskali	təskali
pramhostuː	pramhos/tuː
hawalďanəl	hawal/ďa/nə/l
irakaːnmun	ira/kaːn/mun
bussəldən	bussə/l/də/n
əlit͡ʃəpil	əlit͡ʃəpil
əna	əna
dolgə	dolgə
təːliːda	təːliː/da
uŋundu	uŋun/du
vərhnəimbaskəduː	vərhnəimbaskə/duː
hawalďət͡ʃaːn	hawal/ďə/t͡ʃaː/n
motorjawər	motor/ja/wər
gaŋnəːrəwun	ga/ŋnəː/rə/wun
jəʃo	jəʃo
əːjə	əː/jə
ət	ət
ulgut͡ʃəːnďəm	ulgut͡ʃəːn/ďə/m
hutə	hutə
hutəkəːrwiː	hutə/kəː/r/wiː
umir	umir
səpoʒnikəf	səpoʒnikəf
məːnin	məːni/n
əjəːrən	əjəː/rə/n
tseləj	tseləj
deɲ	deɲ
ribaktuː	ribak/tuː
əjəːt͡ʃəːn	əjəː/t͡ʃəː/n
əjət͡ʃəl	əjə/t͡ʃə/l
guːɲďərə	guːɲ/ďə/rə
ret͡ʃkəduː	ret͡ʃkə/duː
hujukukoːnduː	huju/kukoːn/duː
ťiper	ťiper
tugə	tugə
vremə	vremə
stalə	stalə
znaju	znaju
kuda	kuda
detsə	detsə
ɲaːn	ɲaːn
tamat͡ʃaːn	tama/t͡ʃaː/n
amiːntin	amiːn/tin
sudəwə	sudə/wə
oːt͡ʃəːn	oː/t͡ʃəː/n
əjəːttəkiwun	əjəːt/təki/wun
ulitsə	ulitsə
stəiʃ	stəiʃ
ɲə	ɲə
bili	bili
hoť	hoť
bəjəl	bəjə/l
iɲďəŋkitin	iɲ/ďə/ŋki/tin
priedit	priedit
rimontəjə	rimontə/jə
ət͡ʃil	ə/t͡ʃi/l
oːďərə	oː/ďə/rə
ɲi	ɲi
rimontəkaːnwə	rimontə/kaːn/wə
əːwədəː	əː/wə/dəː
śimjakaːnin	śimja/kaːn/i/n
bolʃoj	bolʃoj
bil	bil
əməːnmurən	əməːn/mu/rə/n
fseh	fseh
ugnali	ugnali
ʒizɲ	ʒizɲ
proʒitə	proʒitə
tukkər	tuk/kər
vśotəki	vśotəki
hot͡ʃ	hot͡ʃ
tirganiːlwə	tirganiː/l/wə
it͡ʃədoːwər	it͡ʃə/doː/wər
kərasnəjarskələː	kərasnəjarsk/ələː
huruwrə	huru/w/rə
taduːdaː	taduː/daː
abult͡ʃa	abul/t͡ʃa
oj	oj
bidɲaʃkə	bidɲaʃkə
həgdigitin	həgdi/gi/tin
śipkaːkaːrduː	śipkaː/kaː/r/duː
ɲamakaːkun	ɲama/kaːkun
umuːnupkənəmil	umuːnup/kənəmi/l
munɲakilt͡ʃal	munɲaki/l/t͡ʃa/l
bəjoďəŋaːt	bəjo/ďəŋaː/t
gələːktədəːt	gələːktə/dəː/t
nada	nada
butťəŋoːl	bu/t/ťəŋoː/l
huwulit	huwuli/t
hurugoːt	huru/goːt
ďantakiːlaː	ďantakiː/laː
nuŋanka	nuŋan/ka
əŋəhiːndəː	əŋəhiː/n/dəː
dinŋiːləːďəŋəːn	dinŋiːləː/ďəŋəː/n
lapəlindaː	lapə/li/n/daː
əŋəhiːtin	əŋəhiː/tin
hoːl	hoː/l
bult͡ʃəl	bu/l/t͡ʃə/l
bihilbun	bi/hi/l/bun
bult͡ʃaďa	bu/l/t͡ʃa/ďa
gələːktənəːkəl	gələːktə/nəː/kəl
ahiːji	ahiː/ji
əmənəndəː	əmən/ə/n/dəː
alaːtťəfkiːl	alaːt/ťə/fkiː/l
əpet	əpet
ďuduːn	ďu/duː/n
guldə	gu/l/də
ɲamajə	ɲama/jə
bakandə	baka/ndə
tugdəː	tug/dəː
buďəŋol	bu/ďəŋo/l
dəγilittə	dəγi/li/t/tə
śipkaːkakaːn	śipkaː/kakaːn
bifkiː	bi/fkiː
hujukukoːn	huju/kukoːn
tuγəwkiː	tuγə/wkiː
atirkaːn	atirkaːn
aŋilawər	aŋi/l/a/wər
uldiːďəkəl	uldiː/ďə/kəl
mərduːwər	mə/r/duː/wər
hutəduːwər	hutə/duː/wər
tala	ta/la
mut	mut
moriktəltə	mo/riktə/l/tə
ətəːp	ə/təː/p
həhənďəriːwətin	həhən/ďə/riː/wə/tin
doːlt͡ʃaːtt͡ʃaran	doːlt͡ʃaːt/t͡ʃa/ra/n
ɲikərəndaː	ɲikə/rə/n/daː
olofśiːdəl	olofśiː/dəl/неясна
kultiritin	kultiri/tin
hərgidaduktin	hər/gida/duk/tin
ťip	ťip
dəgildən	dəgi/l/də/n
gunďənə	gun/ďə/nə
təpkəldən	təpkə/l/də/n
ətirkoːnin	ətirkoːni/n
tardaː	tar/daː
budəp	bu/də/p
bilďəŋol	bi/l/ďəŋo/l
uləːkitťərən	uləːkit/ťə/rə/n
mərtin	mə/r/tin
hurudəːwər	huru/dəː/wər
ɲəkəďərə	ɲəkə/ďə/rə
ahiːnən	ahiː/nən
hutəlgəliji	hutə/l/gəli/ji
doŋotoďoktin	doŋoto/ďo/ktin
gunďərən	gun/ďə/rə/n
dəgilwə	dəgi/l/wə
dəgil	dəgi/l
umuːnuptədaː	umuːnup/tə/daː
dəgildə	dəgi/l/də
huwulitin	huwuli/tin
haːlďakanəm	haːlďa/kanəm
iləːkə	iləː/kə
huruďərə	huru/ďə/rə
haːlďakanəmil	haːlďa/kanəmi/l
ďukt͡ʃaduːwər	ďukt͡ʃa/duː/wər
nuŋartinka	nuŋartin/ka
ogdokoːloːwər	ogdokoː/loː/wər
oďara	o/ďa/ra
tuγəɲiːduː	tuγə/ɲiː/duː
biďəfkiːl	bi/ďə/fkiː/l
tawər	ta/wər
dəgilildədəːji	dəgi/li/ldə/dəː/ji
ɲikəśə	ɲikə/śə
dəgilnun	dəgi/l/nun
əďiŋəː	ə/ďiŋəː
dəgrə	dəg/rə
ista	is/ta
əwadaː	ə/wa/daː
ugiːγit	ugiː/γit
garaduk	gara/duk
buruśo	buru/śo
hərgiːskiː	hərgiːskiː
hiŋilgənduː	hiŋilgən/duː
lupaγo	lupaγo
lupahodal	lupa/hodal
aːhiśa	aː/hi/śa
ďa	ďa
ɲamalaːnkem	ɲama/laːn/kem
tugəďəďəŋoː	tugə/ďə/ďəŋoː
bihim	bi/hi/m
alanďaŋa	alan/ďaŋa
ojotin	ojo/tin
holbal	holba/l
osal	o/sa/l
hoŋonduːn	hoŋo/n/duː/n
horoki	horoki
ugiːdoːtin	ugiːdoː/tin
holbamal	holba/ma/l
bifkiːl	bi/fkiː/l
əfkiːl	ə/fkiː/l
iləːdəː	iləː/dəː
tugəďəfkiːl	tugə/ďə/fkiː/l
ɲikəśodəː	ɲikə/śo/dəː
həwəkiːnun	həwəkiː/nun
girkiːlaďəfkiː	girkiː/la/ďə/fkiː
ďawusaďasatə	ďawu/sa/ďa/sa/tə
girkiːtəːďəśo	girkiː/təː/ďə/śo
aŋilduk	aŋi/l/duk
śitalduk	śita/l/duk
biśə	bi/śə
ahiː	ahiː
ahiːwə	ahiː/wə
bəjəwə	bəjə/wə
ɲikəwkiːdaː	ɲikə/wkiː/daː
eːkunmal	eːkun/mal
muːjan	muː/ja/n
gənnoːfkiː	gənnoː/fkiː
idukpəl	iduk/pəl
ahiːnun	ahiː/nun
ofkiːl	o/fkiː/l
targaśin	tar/gaśin
iduːwəl	iduː/wəl
ətəjətt͡ʃəkəl	ətəjə/t/t͡ʃə/kəl
bəjəŋilbəw	bəjə/ŋi/l/bə/w
ilaːwəl	ilaː/wəl
huruďəndə	huru/ďə/ndə
ɲiːduːdəː	ɲiː/duː/dəː
hə	hə
oďariːwəw	o/ďa/riː/wə/w
əməďəŋoːn	əmə/ďəŋoː/n
aśinduːw	aśin/duː/w
huruďəriːwən	huru/ďəriː/wə/n
isətt͡ʃo	isə/t/t͡ʃo
gunďəp	gunďəp
aŋə	aŋə
eːkurba	eːku/r/ba
əlba	ə/l/ba
hawalďafkiː	hawal/ďa/fkiː
aŋilba	aŋi/l/ba
ofkiːdaː	o/fkiː/daː
muːwə	muː/wə
gənnəːfkiː	gənnəː/fkiː
idukpəldaː	iduk/pəl/daː
əfkoː	ə/fkoː
ɲiːduː	ɲiː/duː
iśəfkəːnmurə	iśə/fkəːn/mu/rə
iśəfkəːkəl	iśə/fkəː/kəl
iduː	iduː
tariŋilin	tari/ŋi/li/n
ətəm	ətə/m
ahuːra	ahuː/ra
ahuːratəː	ahuː/ra/təː
guśokuːn	gu/śo/kuːn
ɲikəsədəː	ɲikə/sə/dəː
ďuktəduːtin	ďuktə/duː/tin
tumɲisadaː	tumɲi/sa/daː
ɲiː	ɲiː
əməśəːn	əmə/śəː/n
haːrgi	haːrgi
əməktəśoːn	əmə/ktə/śoː/n
bəjəŋilbas	bəjə/ŋi/l/ba/s
tumɲirəndaː	tumɲi/rə/n/daː
dərəlduːtin	dərə/l/duː/tin
wamult͡ʃa	wa/mu/l/t͡ʃa
ďəfsamdalon	ďəfsamda/l/o/n
giramdamiːla	giramda/miː/la
ďəw	ďəw
ďəwuwkiː	ďəwu/wkiː
oďaŋaːs	o/ďaŋaː/s
hinə	hinə
noːdaďiŋaːw	noːda/ďiŋaː/w
girkuɲďakal	girku/ɲ/ďa/kal
iduːdəː	iduː/dəː
guśə	gu/śə
ɲikənə	ɲikə/nə
tawar	ta/war
turəːn	turəː/n
aśin	aśin
odan	o/da/n
bəjəduk	bəjə/duk
alitna	alit/na
