iːlаkustə	iːlа/ku/s/tə
qwelalʼlʼе	qwela/lʼ/lʼе
paldʼukus	paldʼu/ku/s
paldʼülʼewlə	paldʼü/lʼewlə
nild	nild
miːtaŋ	miːta/ŋ
nʼanno	nʼanno
qal	qal
neldʼölčeːnǯaŋ	neldʼö/lčeː/nǯa/ŋ
tʼäraŋ	tʼära/ŋ
imasɨqəj	ima/sɨ/qəj
imaqəj	ima/qəj
qalɨmpɔːqəj	qalɨ/mpɔː/qəj
ijajantɨsa	ija/ja/ntɨ/sa
lɨpqɨmɔːtpa	lɨpqɨ/mɔːt/pa
oš	oš
ontɨn	ontɨn
melʼtɨ	melʼtɨ
čʼarɨqalɔːqɨ	čʼarɨ/qa/lɔːqɨ
ijamtɨ	ija/m/tɨ
orɨčʼčʼɨtɨ	orɨ/čʼ/čʼɨ/tɨ
təttantɨ	tətta/ntɨ
topɨti	topɨ/ti
qəə	qəə
loːqɨ	loːq/ɨ
tukɨrɨm	tukɨr/ɨ/m
neːjamtɨ	neː/ja/m/tɨ
sačʼčʼɨmɔːtpa	sačʼčʼɨmɔːt/pa
qälɨporɨ	qälɨ/porɨ
iraiːqɨntɨ	ira/iː/qɨn/tɨ
Loːsɨ	Loːsɨ
qajqo	qaj/qo
ɨra	ɨra
ijaiːntɨ	ija/iː/n/tɨ
olɨ	olɨ
mɔːtqɨn	mɔːt/qɨn
mɔːtqɨntɨ	mɔːt/qɨn/tɨ
ɛːppɨntɨ	ɛː/ppɨ/ntɨ
muntɨ	muntɨ
qontɨqɨjojimpa	qontɨ/qɨ/joji/mpa
olampa	olam/pa
meːltɨqam	meːltɨ/qam
*lipkɨqɨn	*lipkɨ/qɨn
šeːrɨ	šeːr/ɨ
qaqa	qaqa
qɨčʼčʼɨmɔːtpa	qɨčʼčʼɨ/mɔːt/pa
taštɨ	taštɨ
amɛntaɣ	am/ɛnta/ɣ
qoːranɛntak	qoːran/ɛnta/k
qɨčʼčʼɨmɔːlla	qɨčʼčʼɨ/mɔːl/la
torqɨ	torqɨ
qɔːlitɨ	qɔːli/tɨ
natqɨlɛlʼčʼɨn	nat/qɨl/ɛlʼčʼɨ/n
puːtantɨ	puːta/ntɨ
qontaja	qonta/ja
točʼčʼam	točʼčʼa/m
peːqolamnɨt	peː/q/olam/nɨ/t
paqqɨrɨt	paqqɨ/rɨ/t
paqqɨrɨntɨt	paqqɨ/rɨ/ntɨ/t
qɔːlɨjitɨ	qɔːlɨj/i/tɨ
naš	naš
qontɨtɨ	qontɨ/tɨ
əːtɨkɔːl	əːtɨ/kɔːl
tarlä	tar/lä
qənmɨntɨ	qən/mɨ/ntɨ
täpɨn	täp/ɨ/n
nɔːkɨr	nɔːkɨr
ɛːppa	ɛː/ppa
iːjeiːtɨ	iːje/iː/tɨ
koralɨmɨla	kora/lɨ/mɨ/la
qännɔːtɨn	qän/nɔː/tɨn
qaːla	qaːla
šitämteːlʼi	šitä/mteːlʼi
qai	qai
qəːntɨt	qəːntɨ/t
mantäjak	mantä/ja/k
loːqäčʼɛnta	loːq/äčʼɛnta
qontɨšeiŋa	qontɨ/š/ei/ŋa
čʼiːtɨ	čʼiːtɨ
nännɨ	nännɨ
patčʼirɛːŋɨt	pat/čʼir/ɛː/ŋɨ/t
kət	kət
tɛːttɨ	tɛːttɨ
ɨntaːlʼtɨ	ɨntaːlʼ/tɨ
meːŋɨt	meː/ŋɨ/t
tuːtäːsitɨ	tuːt/äː/si/tɨ
qəlʼlʼä	qəlʼ/lʼä
šiːlat	šiːla/t
imaqotamtɨ	imaqota/m/tɨ
sʼilat	sʼila/t
qənnäja	qən/nä/ja
čʼeːlʼa	čʼeːlʼa
qarɨnɨlʼ	qarɨ/n/ɨ/lʼ
poqɨt	po/qɨt
mantäjap	mantä/ja/p
qəːš	qəːš
ɛːsa	ɛː/sa
poqɨnä	po/qɨnä
qontɨšein	qontɨ/š/ei/n
omtɨčʼeːsa	omtɨ/čʼeː/sa
puːlʼɨmtɨ	puːlʼɨ/m/tɨ
patqɨlʼɛːŋɨtɨ	patqɨlʼ/ɛː/ŋɨ/tɨ
čʼoqqolʼɛːŋɨtɨ	čʼoqqo/lʼ/ɛː/ŋɨ/tɨ
nassa	nassa
iːjalʼɨ	iːja/lʼɨ
ɛːmme	ɛː/mme
čʼaŋkɨmä	čʼaŋkɨ/mä
kətɨsɨt	kətɨ/sɨ/t
amɨrɛːlʼa	am/ɨ/r/ɛː/lʼa
lʼosät	lʼosä/t
ši	ši
*qənɨtɨ	*qənɨ/tɨ
üːtɨt	üːtɨ/t
lɨpqɨmɔːnna	lɨpqɨ/mɔːn/na
ijatä	ija/tä
ijatə	ija/tə
amɨrlʼä	am/ɨ/r/lʼä
qəssɨlɨt	qəs/sɨ/lɨt
warqɨnta	warqɨ/nta
qontɨšɛːnta	qontɨ/š/ɛː/nta
pisɨrɨmpa	pisɨ/rɨ/mpa
čʼiqɨlʼtɛːlʼä	čʼiqɨlʼ/t/ɛː/lʼä
puːlɨmtɨ	puːlɨ/m/tɨ
kətɨ	kətɨ
čʼeːlʼtätɨlʼ	čʼeːlʼtätɨlʼ
lımpɨt	lımpɨ/t
nasä	na/sä
seːpɨrɨptäqɨntɨ	seːpɨ/rɨ/ptä/qɨn/tɨ
ortä	or/tä
šip	šip
nı	nı
šäkka	šäkka
taqtaltɨlʼä	taqt/altɨ/lʼä
nʼöːlʼä	nʼöː/lʼä
šittalʼ	šit/talʼ
poːs	poːs
tüːŋa	tüː/ŋa
peːmɨtɨ	peːmɨ/tɨ
tüːnta	tüː/nta
mantɨrnak	mantɨ/r/na/k
qontɨšɛːŋa	qontɨ/š/ɛː/ŋa
loːqɨrɛːŋɨtɨ	loːq/ɨ/r/ɛː/ŋɨ/tɨ
silata	sila/ta
čʼäŋɨmmä	čʼäŋɨ/mmä
mäšintɨ	mäši/ntɨ
omtɨsa	omtɨ/sa
pačʼirɛːlʼa	pačʼi/r/ɛː/lʼa
tišä	tišä
patqɨlɛːlʼa	patqɨl/ɛː/lʼa
ɛːtɨlʼ	ɛːtɨ/lʼ
pɛlʼäktɨ	pɛlʼäk/tɨ
tɨšemtɨ	tɨše/m/tɨ
lʼos	lʼos
iːja	iːja
nʼöːntɨt	nʼöː/ntɨ/t
surɨt	surɨ/t
nɨnä	nɨnä
tɨmnʼäqım	tɨmnʼä/qı/m
šäqɨmpɔːtɨt	šäqɨ/mpɔː/tɨt
tülʼčʼa	tü/lʼčʼa
tiːtäkat	tiːtäka/t
šäkɨmpɔːtɨt	šäkɨ/mpɔː/tɨt
šäːkɨmpɔːtɨt	šäːkɨ/mpɔː/tɨt
tɨmnʼaqımɨ	tɨmnʼa/qı/mɨ
tolʼčʼilʼ	tolʼčʼi/lʼ
sɨrɨ	sɨrɨ
iːmpatɨ	iː/mpa/tɨ
toːpɨt	toːpɨ/t
qotta	qotta
čʼarɨ	čʼarɨ
täqɨmpɔːtɨt	täqɨ/mpɔː/tɨt
pitčʼet	pitčʼe/t
ammäit	amm/äi/t
amnɨtɨ	am/nɨ/tɨ
təːka	təːka
munɨmtɨ	munɨ/m/tɨ
qɔːtɨ	qɔːtɨ
tutɔːlnet	tut/ɔːl/ne/t
qalap	qala/p
ammeit	amm/ei/t
šutɨlʼ	šutɨ/lʼ
ontɨkine	ontɨ/kine
lətɨ	lə/tɨ
iːjanɨk	iːja/nɨk
kumɨlʼ	kumɨ/lʼ
sɔːntɨŋɨtɨ	sɔːntɨ/ŋɨ/tɨ
čʼatɨŋɨt	čʼatɨ/ŋɨ/t
maːkqɨp	maːkqɨ/p
iralʼ	ira/lʼ
tıːmonɨ	tıːmo/nɨ
qənɨŋnɨ	qənɨŋ/nɨ
paqtɨlʼä	paqtɨ/lʼä
uquuu	uquuu
pöːtɛntak	pöːt/ɛnta/k
tıːmona	tıːmo/na
qəːnirana	qəːnira/na
leːpä	leːpä
tintäna	tintäna
lolʼ	lo/lʼ
tıːtɛːŋɨtɨ	tıː/t/ɛː/ŋɨ/tɨ
kətɨntɨt	kətɨ/ntɨ/t
porä	porä
tannɛnantɨ	tann/ɛna/ntɨ
namɨp	namɨ/p
čʼoqolpatɨ	čʼoqo/l/pa/tɨ
miːšɔːllä	miːš/ɔːl/lä
qəntɨtɨ	qən/tɨ/tɨ
tɨtɨp	tɨtɨ/p
čʼatɨsä	čʼatɨ/sä
amɨrsamtɨ	am/ɨ/r/sa/m/tɨ
kostrʼulʼantɨ	kostrʼulʼa/ntɨ
patqɨllä	pat/qɨl/lä
tam	tam
tamɨm	tam/ɨ/m
okoškat	okoška/t
səːtɨ	səː/tɨ
taŋaltɛːnta	taŋ/alt/ɛː/nta
lakasä	laka/sä
üːqɨlʼelʼčʼɛnta	üːqɨlʼ/elʼčʼ/ɛnta
čʼatɨntɨ	čʼatɨ/n/tɨ
nɨːnto	nɨː/nto
kurolʼna	kur/olʼ/na
mɨka	mɨka
puršimɔːtıːja	purši/mɔːt/ıː/ja
peːŋal	peː/ŋa/l
täkkelʼa	täkke/lʼa
ɔːqɨt	ɔː/qɨt
nɨːŋɨlʼe	nɨː/ŋɨlʼe
lakasa	laka/sa
tantɨlʼe	tantɨ/lʼe
nɨːnetɨ	nɨː/netɨ
šeːrlʼa	šeːr/lʼa
šäqqɨnta	šäqqɨ/nta
čʼoip	čʼoi/p
čʼoj	čʼoj
amɨrejnta	am/ɨ/r/ej/nta
qɨːqɨllʼe	qɨː/qɨl/lʼe
paqtat	paqta/t
moːrɨ	moːrɨ
čʼantoːqɨt	čʼantoː/qɨt
qoːtältɨmpatɨ	qoːt/äl/tɨ/mpa/tɨ
čʼıːmɨp	čʼıːmɨ/p
qɔːt	qɔːt
mannɨmpɨsam	mannɨ/mpɨ/sa/m
tep	tep
qonɨčʼa	qonɨ/čʼa
qoŋɨtɨ	qo/ŋɨ/tɨ
čʼiːqqɨmɔːtpa	čʼiːqqɨ/mɔːt/pa
nilʼčʼilʼ	nilʼčʼi/lʼ
ollɨtɨ	ollɨ/tɨ
čʼıŋkɨt	čʼıŋkɨ/t
ɨnna	ɨnna
pačʼalqo	pačʼ/al/qo
orqɨltɨt	orqɨl/tɨ/t
mišallʼe	miš/al/lʼe
ɛsalɔːtɨn	ɛsa/lɔː/tɨn
čʼumɨlʼ	čʼumɨ/lʼ
qumpa	qu/mpa
amɛːlʼa	am/ɛː/lʼa
tüːŋɔːtɨn	tüː/ŋɔː/tɨn
omtijɔːtɨn	omti/jɔː/tɨn
nɨlʼčʼik	nɨlʼčʼi/k
čʼapqaš	čʼapqaš
poːsa	poː/sa
sepelak	sepelak
sämnälʼä	sämnälʼä
ämäp	ämä/p
oqɨllɨsa	oqɨllɨ/sa
lä	lä
lɨpkomɔːtɨimpa	lɨpko/mɔːt/ɨi/mpa
čʼelʼiŋɛːlʼa	čʼelʼi/ŋ/ɛː/lʼa
tottɛntɨtɨ	tott/ɛ/ntɨ/tɨ
posä	po/sä
rakšältättɨ	rakš/ält/ättɨ
puːlʼa	puːlʼa
posa	po/sa
rakšaltɨtɨ	rakš/altɨ/tɨ
ɛsa	ɛsa
ontä	ontä
qontɨšeŋa	qontɨ/š/e/ŋa
patčʼalpatɨ	patčʼ/al/pa/tɨ
alʼčʼa	alʼčʼa
tolʼ	to/lʼ
nɨtalʼa	nɨta/lʼa
qatɔːlnɨt	qat/ɔːl/nɨ/t
šɛːqɨntɔːtɨt	šɛːqɨ/ntɔː/tɨt
pičʼitɨ	pičʼi/tɨ
čʼuqɨlit	čʼuqɨ/li/t
pičʼim	pičʼi/m
amɨrsalʼ	am/ɨ/r/sa/lʼ
qäːqɨnɨt	qäː/qɨn/ɨt
ɨnnät	ɨnnä/t
omtɨlʼ	omtɨ/lʼ
ɨlqɨnɨ	ɨl/qɨnɨ
koraltɨtɨ	kor/altɨ/tɨ
qurɨlʼak	qurɨ/lʼa/k
qətsattɨ	qətsat/tɨ
ɨpqälʼolʼna	ɨp/qälʼ/olʼ/na
lʼipɨ	lʼipɨ
seppɛːnta	sep/p/ɛː/nta
teːmtɨ	teːmtɨ
kusa	kusa
kunä	kunä
tämtop	tämto/p
čʼəːsɨ	čʼəːsɨ
kurreŋit	kurr/e/ŋi/t
ɨpaŋɨtɨ	ɨpa/ŋɨ/tɨ
kotɨk	kotɨk
ütteŋito	ütt/e/ŋi/to
irat	ira/t
qonteja	qont/e/ja
čʼarɨp	čʼarɨp
kontɨ	kontɨ
qɨr	qɨr
paŋɨsä	paŋɨ/sä
nilleːlʼa	nilleː/lʼa
silaltet	sil/alt/e/t
tɛːmnɨntɨ	tɛːmnɨ/n/tɨ
čʼattetɨ	čʼatt/e/tɨ
qəjentɨ	qəj/e/ntɨ
tänɨtɨ	tänɨ/tɨ
ɨːrɨŋ	ɨːrɨŋ
nʼöŋa	nʼö/ŋa
šitqo	ši/tqo
sɨqɨleŋa	sɨqɨl/e/ŋa
nʼenʼimɔːnna	nʼenʼi/mɔːn/na
qälimpɨptät	qäl/i/mpɨ/ptä/t
šelʼqup	šelʼqup
pɛlitɨmpal	pɛli/tɨ/mpa/l
šelqup	šelqup
toːta	toːta
qoːp	qoː/p
čʼošsä	čʼoš/sä
üntinimtɨje	ünti/nimtɨje
možet	možet
surɨlʼa	surɨ/lʼa
əsɨtɨ	əsɨ/tɨ
ətɨmɨntɨ	ətɨmɨntɨ
sarrejietɨ	sarr/ej/ie/tɨ
pop	po/p
pom	po/m
qäntɨt	qäntɨ/t
mattältentit	matt/äl/t/e/nti/t
qättällä	qätt/äl/lä
šinet	šinet
pijap	pija/p
pɔːrontɨ	pɔːro/ntɨ
namɨša	namɨša
qontartɨ	qontartɨ
ont	ont
tɛnɨmɨt	tɛnɨmɨ/t
tıšqɨmɔːnna	tıšqɨ/mɔːn/na
kəlʼčʼɔːtɨt	kə/lʼčʼɔː/tɨt
nʼüšimɨt	nʼüši/mɨt
amtɨt	am/tɨ/t
qənnɨntɔː	qən/nɨ/ntɔː
košinamɨt	košinamɨt
ɔːlʼčʼɛnta	ɔːlʼčʼ/ɛnta
suːrqımɨ	suːr/qı/mɨ
puraaa	puraaa
nɨː	nɨː
tüːŋɔːtɨt	tüː/ŋɔː/tɨt
miːšalnɔːqɨj	miːš/al/nɔː/qɨj
qəttɛːŋɨtɨ	qətt/ɛː/ŋɨ/tɨ
aːsap	aːsa/p
əːtɨsa	əːtɨ/sa
ilɨmpɔːtɨt	ilɨ/mpɔː/tɨt
najɛnta	najɛnta
qatamol	qatamol
ammɛːjit	amm/ɛː/ji/t
qəːlɨlʼlʼä	qəːlɨ/lʼ/lʼä
kušat	kušat
qoltit	qolti/t
mantelɔːlpɨlʼä	mante/lɔːl/pɨ/lʼä
suːrɨtqo	suːrɨ/tqo
mantalpelʼa	mant/al/pe/lʼa
