zəxvətili	zəxvətili
wras	wras
hagditmər	hagdi/tmər
əʃo	əʃo
raskaʒu	raskaʒu
t͡ʃistij	t͡ʃistij
buːh	buːh
tər	tər
daʒə	daʒə
deɲgi	deɲgi
dolboltono	dolboltono
rebitiʃək	rebitiʃək
ne	ne
videlali	videlali
virəsli	virəsli
pərniʃkə	pərniʃkə
tihə	tihə
hərəso	hərəso
tartəːki	tartəːki
ətprəvlali	ətprəvlali
bəlezɲ	bəlezɲ
pləhoj	pləhoj
kojəkak	kojəkak
viʒəli	viʒəli
kovo	kovo
deneg	deneg
jest	jest
damka	damka
brali	brali
ʃoto	ʃoto
raskazutə	raskazutə
kəkoj	kəkoj
səfhos	səfhos
osiɲ	osiɲ
boliniː	boliniː
t͡ʃistəj	t͡ʃistəj
kəkojtə	kəkojtə
dilat͡ʃa	dilat͡ʃa
dilat͡ʃ	dilat͡ʃ
əlit͡ʃəpil	əlit͡ʃəpil
əna	əna
dolgə	dolgə
soloːki	soloːki
jəʃo	jəʃo
ət	ət
grit	grit
umir	umir
səpoʒnikəf	səpoʒnikəf
tseləj	tseləj
deɲ	deɲ
ťiper	ťiper
tapat͡ʃa	tapat͡ʃa
vremə	vremə
stalə	stalə
oːn	oːn
ut͡ʃilśə	ut͡ʃilśə
hukuləː	hukuləː
təskali	təskali
nim	nim
nuŋənduːn	nuŋənduːn
kamaγaː	kamaγaː
skolkə	skolkə
hodi	hodi
eti	eti
stroili	stroili
ʒe	ʒe
gruʒili	gruʒili
hata	hata
lərok	lərok
nit͡ʃəvo	nit͡ʃəvo
netu	netu
taʃim	taʃim
bit͡ʃəvoj	bit͡ʃəvoj
əji	əji
znaju	znaju
ətets	ətets
pəruski	pəruski
davno	davno
hajaːlə	hajaːlə
iloː	iloː
tajmeɲ	tajmeɲ
tarjaːkaklaː	tarjaːka/klaː
śergejif	śergejif
sergejew	sergejew
vtəroj	vtəroj
pervij	pervij
trəfim	trəfim
ďiːγit	ďiːγit
t͡ʃipkaːn	t͡ʃipkaːn
nul	nul
tsəlij	tsəlij
t͡ʃaːskiː	t͡ʃaːskiː
uʒ	uʒ
gďətə	gďətə
kəgda	kəgda
uʃli	uʃli
toːliː	toːliː
ərə	ərə
tunŋa	tunŋa
fśe	fśe
aŋti	aŋti
padrat	padrat
pau	pau
orolo	orolo
kət	kət
tagda	tagda
suʃiť	suʃiť
maleɲka	maleɲka
ar	ar
pətoːm	pətoːm
wuse	wuse
ol	ol
əh	əh
əśo	əśo
dla	dla
rəzgar	rəzgar
rəboti	rəboti
əleɲi	əleɲi
ubiga	ubiga
prije	prije
kurəleśim	kurəleśim
jedim	jedim
nor	nor
iz	iz
bərasti	bərasti
ďəlali	ďəlali
bərəsťa	bərəsťa
təːduk	təːduk
sinə	sinə
medl	medl
saməj	saməj
gniluski	gniluski
vot	vot
ətirkoːn	ətirkoːn
dimokura	dimokura
tut	tut
wizďə	wizďə
dimokur	dimokur
oleɲam	oleɲam
əta	əta
taskajem	taskajem
iʃo	iʃo
moːtiːt	moːtiːt
wolka	wolka
dolboltənə	dolboltənə
ʃtop	ʃtop
dolbo	dolbo
boγ	boγ
vəri	vəri
kak	kak
kuda	kuda
ajat	ajat
ɲaːn	ɲaːn
lupaγo	lupaγo
hərgiːskiː	hərgiːskiː
uʒe	uʒe
uʃ	uʃ
detsə	detsə
ťip	ťip
se	se
mut	mut
znat͡ʃit	znat͡ʃit
atirkaːn	atirkaːn
təːr	təːr
pətkət	pətkət
əpet	əpet
aramaː	aramaː
nuŋənməːn	nuŋənməːn
nada	nada
