oːdən	oː/də/n
təγət͡ʃon	təγə/t͡ʃo/n
əmərəw	əmə/rə/w
hutəlwər	hutə/l/wər
ŋənəďəŋnərəwun	ŋənə/ďə/ŋnə/rə/wun
prəduktələwər	prəduktə/l/ə/wər
it͡ʃərə	it͡ʃə/rə
əməďəŋoːn	əmə/ďəŋoː/n
odan	o/da/n
ofkiːl	o/fkiː/l
ŋənərə	ŋənə/rə
uldəwən	uldə/wə/n
oldolwə	oldo/l/wə
irəːksəwən	irəːksə/wə/n
gunďərə	gun/ďə/rə
irəːksəwən	irəːksə/wə/n
ďajaďan	ďaja/ďa/n
dəgilwə	dəgi/l/wə
əwanda	ə/wa/n/da
bit͡ʃoːwun	bi/t͡ʃoː/wun
bit͡ʃoːwun	bi/t͡ʃoː/wun
bit͡ʃoːwun	bi/t͡ʃoː/wun
oďəŋnərəwun	o/ďə/ŋnə/rə/wun
oːďərə	oː/ďə/rə
oŋnərəwun	o/ŋnə/rə/wun
aŋiran	aŋi/ra/n
oːrə	oː/rə
oːrə	oː/rə
ə	ə
ə	ə
ə	ə
huruŋnərəwun	huru/ŋnə/rə/wun
ə	ə
əməŋnərəwun	əmə/ŋnə/rə/wun
əməŋnərəwun	əmə/ŋnə/rə/wun
əməŋnərəwun	əmə/ŋnə/rə/wun
oďarəwun	o/ďa/rə/wun
dərəlduːtin	dərə/l/duː/tin
balokilduːtin	baloki/l/duː/tin
tihaktaďərən	tiha/kta/ďə/rə/n
oďərə	o/ďə/rə
aŋiwan	aŋi/wa/n
aŋiwan	aŋi/wa/n
oːďan	oː/ďa/n
uləːkitťərən	uləːkit/ťə/rə/n
bəjiːtt͡ʃərən	bəjiː/t/t͡ʃə/rə/n
goγoďəkoːrən	goγo/ďə/koː/rə/n
hurut͡ʃol	huru/t͡ʃo/l
huruďərə	huru/ďə/rə
it͡ʃərəwunduː	it͡ʃə/rə/wun/duː
aŋirə	aŋi/rə
guləlduː	gulə/l/duː
znəkomijilbi	znəkomiji/l/bi
ďuːlduːtin	ďuː/l/duː/tin
əməːnmurən	əməːn/mu/rə/n
urinərəwun	urinə/rə/wun
art͡ʃərəwun	art͡ʃə/rə/wun
art͡ʃarəwun	art͡ʃa/rə/wun
dəγirəwun	dəγi/rə/wun
aŋiďan	aŋi/ďa/n
hururə	huru/rə
hururə	huru/rə
gənnoːrəwun	gənnoː/rə/wun
bisin	bi/si/n
ďapkaduːn	ďapka/duː/n
biďəfkiːl	bi/ďə/fkiː/l
əmərə	əmə/rə
əmərə	əmə/rə
əmərə	əmə/rə
əmərə	əmə/rə
tumɲirəndaː	tumɲi/rə/n/daː
uďaltin	uďa/l/tin
prəduktələ	prəduktə/l/ə
ďuduːn	ďu/duː/n
ďuːlduː	ďuː/l/duː
ɲikərəndaː	ɲikə/rə/n/daː
ŋənəďəďən	ŋənə/ďə/ďə/n
ət͡ʃil	ə/t͡ʃi/l
it͡ʃərəwun	it͡ʃə/rə/wun
oːŋkaːnən	oːŋkaːn/ə/n
pəktiroːnən	pəktiroːn/ə/n
oldolə	oldo/l/ə
əlba	ə/l/ba
ďuːltin	ďuː/l/tin
ďuːltin	ďuː/l/tin
ɲaŋtalə	ɲaŋta/l/ə
ɲaŋtalə	ɲaŋta/l/ə
biŋkiːn	bi/ŋkiː/n
bifkiːl	bi/fkiː/l
əton	ə/to/n
giːl	giː/l
tapat͡ʃaːtil	tapat͡ʃaːti/l
jaːdantsəwil	jaːdantsəwi/l
haːdont͡ʃinil	haːdont͡ʃini/l
palatkəl	palatkə/l
patəjil	patəji/l
maril	mari/l
nuŋanduːn	nuŋan/duː/n
holbal	holba/l
hoːl	hoː/l
gunən	gun/ə/n
gunən	gun/ə/n
gunən	gun/ə/n
gunən	gun/ə/n
ďantakiːl	ďantakiː/l
əfkiːl	ə/fkiː/l
ďantakiːl	ďantakiː/l
tirgallan	tirga/l/la/n
turəːn	turəː/n
beresten	bereste/n
upkat͡ʃin	upkat͡ʃi/n
məːnin	məːni/n
gərbiːn	gərbiː/n
familijən	familijə/n
ətirkoːnin	ətirkoːni/n
əɲinin	əɲini/n
gərbin	gərbi/n
lapən	lapə/n
ɲaŋtal	ɲaŋta/l
ďajan	ďaja/n
dəgil	dəgi/l
bit͡ʃol	bi/t͡ʃo/l
bit͡ʃol	bi/t͡ʃo/l
hururəwun	huru/rə/wun
huwulin	huwuli/n
hururəwun	huru/rə/wun
hururəwun	huru/rə/wun
hururəwun	huru/rə/wun
hururəwun	huru/rə/wun
huwulin	huwuli/n
əmərəwun	əmə/rə/wun
əmərəwun	əmə/rə/wun
bəjəl	bəjə/l
munɲakilt͡ʃal	munɲaki/l/t͡ʃa/l
bussəldən	bussə/l/də/n
bit͡ʃon	bi/t͡ʃo/n
bit͡ʃon	bi/t͡ʃo/n
təpkəldən	təpkə/l/də/n
bult͡ʃəl	bu/l/t͡ʃə/l
oldonwon	oldo/n/wo/n
oldonwon	oldo/n/wo/n
ət͡ʃol	ə/t͡ʃo/l
kanikulilwun	kanikuli/l/wun
ďəfsamdalon	ďəfsamda/l/o/n
dəgildən	dəgi/l/də/n
bit͡ʃoːl	bi/t͡ʃoː/l
haŋkəlwun	haŋkə/l/wun
gowolt͡ʃol	gowo/l/t͡ʃo/l
aːŋďərən	aːŋ/ďə/rə/n
guɲďərən	guɲ/ďə/rə/n
bit͡ʃoːn	bi/t͡ʃoː/n
bit͡ʃoːn	bi/t͡ʃoː/n
bit͡ʃoːn	bi/t͡ʃoː/n
bit͡ʃoːn	bi/t͡ʃoː/n
iɲďərən	iɲ/ďə/rə/n
inďərən	in/ďə/rə/n
gunďərən	gun/ďə/rə/n
biďirən	bi/ďi/rə/n
aŋiďərən	aŋi/ďə/rə/n
bilďəŋol	bi/l/ďəŋo/l
arkirən	arki/rə/n
uloːkkirən	uloːkki/rə/n
loporoːrən	loporoː/rə/n
bururən	buru/rə/n
əjəːrən	əjəː/rə/n
manarən	mana/rə/n
hoŋonduːn	hoŋo/n/duː/n
biďən	bi/ďə/n
sururən	suru/rə/n
aŋirən	aŋi/rə/n
hururən	huru/rə/n
hururən	huru/rə/n
l	l
