nuŋəməːn	nuŋəməːn
bimnin	bimnin
ej	ej
bidɲaʃkə	bidɲaʃkə
oj	oj
lupahodal	lupa/hodal
kərasnəjarskələː	kərasnəjarsk/ələː
paka	paka
alanďaŋa	alan/ďaŋa
əbəj	əbəj
t͡ʃemokokoːn	t͡ʃemo/kokoːn
həgdiŋə	həgdiŋə
ďəw	ďəw
əsile	əsile
guďeːj	guďeːj
haːrgi	haːrgi
zdraːstwujťe	zdraːstwujťe
antimati	anti/mati
nəlki	nəlki
trafim	trafim
balnitsa	balnitsa
ʃas	ʃas
gunďəp	gunďəp
hə	hə
igo	igo
nado	nado
ladno	ladno
vet͡ʃərəm	vet͡ʃərəm
wot	wot
horoki	horoki
iːduː	iːduː
jaŋəti	jaŋəti
əduk	əduk
hoť	hoť
oːkiː	oːkiː
bili	bili
hot͡ʃ	hot͡ʃ
priedit	priedit
vśotəki	vśotəki
tri	tri
ɲə	ɲə
ɲi	ɲi
proʒitə	proʒitə
bil	bil
danila	danila
fseh	fseh
ʒizɲ	ʒizɲ
toʒə	toʒə
bolʃoj	bolʃoj
tam	tam
ugnali	ugnali
ulitsə	ulitsə
stəiʃ	stəiʃ
nikalajəvit͡ʃ	nikalajəvit͡ʃ
strogij	strogij
olofśiːdəl	olofśiː/dəl/неясна
arakuːkan	ara/kuːkan
kətəkoːkun	kətə/koːkun
uŋundu	uŋun/du
arakuːkaːn	ara/kuːkaːn
haːlďakanəm	haːlďa/kanəm
doŋotoďoktin	doŋoto/ďo/ktin
ďəwurkəlti	ďəwu/rkə/lti
nuliwoj	nuliwoj
tolko	tolko
umukoːn	umukoːn
haraʃo	haraʃo
bolʃə	bolʃə
ut͡ʃiťelɲitsa	ut͡ʃiťelɲitsa
bun	bun
aːt͡ʃin	aːt͡ʃin
idukpəl	iduk/pəl
ni	ni
aśin	aśin
ďawu	ďawu
ďaːr	ďaːr
t͡ʃum	t͡ʃum
bərəsťanoj	bərəsťanoj
bərəsťanoj	bərəsťanoj
əsilə	əsilə
takoj	takoj
ədin	ədin
anan	anan
ami	ami
apať	apať
əːduk	əːduk
əγiː	əγiː
tolko	tolko
dəma	dəma
amaːkaː	amaːkaː
sə	sə
bolʃə	bolʃə
dariːləː	dariː/ləː
tuγi	tuγi
əɲijo	əɲi/jo
əsilə	əsilə
taːliː	taːliː
əːkuːn	əːkuːn
taːliː	taːliː
t͡ʃum	t͡ʃum
ɲan	ɲan
aŋə	aŋə
kto	kto
diːskiː	diːskiː
alik	alik
tuγi	tuγi
nuliwoj	nuliwoj
aha	aha
haraʃo	haraʃo
dəma	dəma
ďaːr	ďaːr
mit	mit
jeʃo	jeʃo
ŋəpkəkəːləː	ŋəpkəkəː/ləː
diːskiː	diːskiː
ɲan	ɲan
umukoːn	umukoːn
prəmhos	prəmhos
tug	tug
əhiː	əhiː
kələ	kələ
kto	kto
letə	letə
aːt͡ʃin	aːt͡ʃin
kək	kək
takoj	takoj
abratnə	abratnə
jeʃo	jeʃo
abratnə	abratnə
geː	geː
śipkaːkakaːn	śipkaː/kakaːn
anan	anan
apať	apať
kələ	kələ
ani	ani
hujukukoːn	huju/kukoːn
ni	ni
u	u
ani	ani
mit	mit
ədin	ədin
əγiː	əγiː
əːkuːn	əːkuːn
ɲaŋɲa	ɲaŋɲa
giramdamiːla	giramda/miː/la
ɲamalaːnkem	ɲama/laːn/kem
onmər	on/mər
goʃaja=	goʃa/ja=
letəʒə	letə/ʒə
ďirikat͡ʃaːn	ďirika/t͡ʃaːn
ugiːγit	ugiː/γit
tajgato	tajga/to
kilometrduliː	kilometr/duliː
ďapkutalwaːγint͡ʃə	ďapkutal/waː/γint͡ʃə
əɲoː	əɲoː
nawerna	nawerna
taduk	taduk
tak	tak
ilan	ilan
ɲamakaːkun	ɲama/kaːkun
taduk	taduk
tuγ	tuγ
əɲoː	əɲoː
wirtolottulaː	wirtolot/tulaː
ďo	ďo
pəktiron	pəktiron
ilan	ilan
snowa	snowa
hajalə	hajalə
