airspeed	air/speed
flowchart	flow/chart
decency	dec/ency
transcendency	transcend/ency
presence	pres/ence
upstairs	up/stairs
incumbency	incumb/ency
bribery	brib/ery
recrudescence	recrudesc/ence
joinery	join/ery
backpedal	back/pedal
adultery	adult/ery
contingency	conting/ency
heartbroken	heart/broken
heartburn	heart/burn
predisposition	pre/dispos/ition
suburbanite	sub/urban/ite
anthropological	anthrop/olog/ical
coddle	coddle
offstage	off/stage
airline	air/line
curator	curator
horseshoe	horse/shoe
forward	forward
toe	toe
standpoint	stand/point
prune	prune
coach	coach
launch	launch
brushwood	brush/wood
guard	guard
misappropriate	mis/appropriate
blimpish	blimp/ish
misled	mis/led
exorbitance	exorbit/ance
expressway	express/way
anyplace	any/place
handpick	hand/pick
corinthian	corinth/ian
repellent	repell/ent
palish	pal/ish
foppish	fopp/ish
jesuitical	jesuit/ical
pinkish	pink/ish
hyperbolical	hyperbol/ical
sufficient	suffici/ent
differential	differ/ent/ial
gibraltarian	gibraltar/ian
firepower	fire/power
chronically	chronic/ally
hotfoot	hot/foot
waken	wak/en
archaism	archa/ism
graphical	graph/ical
roundup	round/up
alongside	a/long/side
tripartite	tri/part/ite
radioactivity	radio/act/iv/ity
motor	motor
steamship	steam/ship
headlamp	head/lamp
substantiate	substanti/ate
triumvirate	triumvir/ate
sip	sip
sip	sip
pupate	pup/ate
bipartite	bi/part/ite
persuasive	per/suas/ive
imponderable	im/ponder/able
resonant	reson/ant
frugality	frugal/ity
undergrad	under/grad
housekeeping	house/keeping
community	commun/ity
undergrad	under/grad
conclusive	conclus/ive
pontificate	pontific/ate
beachhead	beach/head
concordant	concord/ant
roughhouse	rough/house
monogamous	monogam/ous
rigidity	rigid/ity
puritanism	pur/it/an/ism
rampant	ramp/ant
pugnacity	pugnac/ity
waxwork	wax/work
regressive	regress/ive
hothouse	hot/house
bonniest	bonni/est
inanity	inan/ity
plushest	plush/est
numerable	numer/able
proudest	proud/est
curatorship	curator/ship
negative	negat/ive
meetinghouse	meeting/house
felicitous	felicit/ous
treatable	treat/able
narrowest	narrow/est
exploratory	explor/at/ory
palatable	palat/able
triviality	trivial/ity
choicest	choic/est
underscore	under/score
persuadable	persuad/able
surliest	surli/est
deplorable	deplor/able
horrifically	horr/if/ic/ally
accompaniment	ac/compani/ment
polarize	pol/ar/ize
workhorse	work/horse
describable	describ/able
overburden	over/burden
afire	a/fire
outskirts	out/skirts
freshman	fresh/man
apart	a/part
outdistance	out/dist/ance
monophonic	mono/phon/ic
sybaritic	sybar/it/ic
lineman	line/man
overthrow	over/throw
trainable	train/able
sacristan	sacrist/an
workshop	work/shop
confinement	confine/ment
punishment	punish/ment
ceaseless	cease/less
joyless	joy/less
entitlement	entitle/ment
inviolate	in/violate
classless	class/less
luckless	luck/less
judgement	judge/ment
voteless	vote/less
versification	vers/ific/ation
disservice	dis/serv/ice
workmanlike	work/man/like
fluffy	fluff/y
plucky	pluck/y
breathy	breath/y
coinage	coin/age
bountiful	bounti/ful
ahead	a/head
stodgy	stodg/y
carriage	carri/age
outflow	out/flow
bandage	band/age
uneconomical	un/ec/onom/ical
tasteless	taste/less
bulky	bulk/y
overstock	over/stock
atomize	atom/ize
aggrandizement	ag/grand/ize/ment
diplomatically	diplomat/ic/ally
infamous	in/fam/ous
dispassionate	dis/passion/ate
insensitivity	in/sensitiv/ity
symbolically	symbol/ic/ally
infelicitous	in/felicit/ous
toothy	tooth/y
cheeky	cheek/y
under	under
dissimilar	dis/similar
squinty	squint/y
collectivization	collect/iv/iz/ation
cheerful	cheer/ful
poofy	poof/y
yeasty	yeast/y
