Noʼjim	Noʼjim
kʼuhjnem	kʼuhjnem
Jachin	Jachin
suq	suq
Chi	Chi
qʼaqʼ	qʼaqʼ
Xu	Xu
aninaq	aninaq
tzuqbʼal	tzuqbʼal
ko	ko
taqanik	taqanik
joron	joron
kowilaj	kowilaj
latzʼ	latzʼ
choyibʼal	choyibʼal
alkalte	alkalte
Nabʼe	Nabʼe
Jelaʼ	Jelaʼ
kon	kon
Woktzʼibʼabʼal	Woktzʼibʼabʼal
wuj	wuj
qʼaʼm	qʼaʼm
chij	chij
ixim	ixim
tzʼunuj	tzʼunuj
jupuq	jupuq
Congo	Congo
del	del
Democrática	Democrática
República	República
saqkoʼr	saqkoʼr
Lal	Lal
saʼy	saʼy
saqmoʼl	saqmoʼl
ukʼaʼ	ukʼaʼ
Kebʼ	Kebʼ
apan	apan
qʼequʼm	qʼequʼm
aqʼan	aqʼan
mayul	mayul
Rax	Rax
Talin	Talin
tzijom	tzijom
cholaj	cholaj
Lemoʼ	Lemoʼ
ajtʼisoʼm	ajtʼisoʼm
pʼot	pʼot
rajawaxik	rajawaxik
80%	80%
pix	pix
Maj	Maj
tʼuyul	tʼuyul
Jat	Jat
chanim	chanim
ekʼi	ekʼi
lo	lo
juwinaq	juwinaq
chʼabʼal	chʼabʼal
kʼicheʼ	kʼicheʼ
xuquje	xuquje
«	«
Nojim	Nojim
kaxlan	kaxlan
Latzʼ	Latzʼ
uwuq	uwuq
Xoʼl	Xoʼl
timinit	timinit
asosyasyon	asosyasyon
Jobʼ	Jobʼ
chʼil	chʼil
xunkur	xunkur
kʼate	kʼate
jobʼ	jobʼ
qʼuqʼ	qʼuqʼ
triko	triko
Chuta	Chuta
Luʼs	Luʼs
waʼkatel	waʼkatel
500	500
300	300
muchuʼl	muchuʼl
Jeriʼ	Jeriʼ
julajuj	julajuj
sanik	sanik
alaq	alaq
wene	wene
wajxaqibʼ	wajxaqibʼ
qʼojom	qʼojom
qʼatzu	qʼatzu
qʼalaj	qʼalaj
Uj	Uj
yabʼil	yabʼil
xibʼibʼal	xibʼibʼal
axux	axux
Miqʼin	Miqʼin
molonel	molonel
tzijtal	tzijtal
Awas	Awas
wajxaqlajuj	wajxaqlajuj
josbʼal	josbʼal
tzʼalam	tzʼalam
ajtzʼaq	ajtzʼaq
Chwikabyok	Chwikabyok
Abʼaj	Abʼaj
Xelajuʼ	Xelajuʼ
Aninaqil	Aninaqil
Qʼumarkaj	Qʼumarkaj
ixtutzʼ	ixtutzʼ
Naqaj	Naqaj
Kʼa	Kʼa
Kojonel	Kojonel
te	te
Tzebʼal	Tzebʼal
jupulik	jupulik
Paqal	Paqal
Aj	Aj
yoqʼoj	yoqʼoj
...	...
cholbʼal	cholbʼal
jujun	jujun
chomaʼq	chom/aʼq
Pal	Pal
xoqujeʼ	xoqujeʼ
bʼinel	bʼinel
Jawchiʼ	Jawchiʼ
Chʼanal	Chʼanal
ajtiʼj	ajtiʼj
xu	xu
xan	xan
Kaxlaʼn	Kaxlaʼn
uwosaq	uwosaq
palomax	palomax
xuʼy	xuʼy
ajanel	ajanel
tzʼaralik	tzʼaralik
Tenaʼ	Tenaʼ
Kʼakʼ	Kʼakʼ
chakach	chakach
kʼisis	kʼisis
pan	pan
kʼaʼm	kʼaʼm
ulew	ulew
yawal	yawal
Xalqʼat	Xalqʼat
poʼt	poʼt
tzurik	tzurik
loqʼoj	loqʼoj
qʼoqʼ	qʼoqʼ
Ajitz	Ajitz
jal	jal
”	”
Xep	Xep
Najil	Najil
Mayabʼ	Mayabʼ
chʼumil	chʼumil
melarsoprol	melarsoprol
tijobʼal	tijobʼal
Dyos	Dyos
Entonses	Entonses
T.b.r.	T.b.r.
Kamul	Kamul
kumatz	kumatz
wereʼaj	wereʼaj
chiʼl	chiʼl
siwan	siwan
kʼaqat	kʼaqat
Kʼate	Kʼate
Ajchak	Ajchak
qʼaqʼal	qʼaqʼal
