pastanelerde	pastane/ler/de
kardeSidir	kardeS/i/dir
dergahlar	dergah/lar
Onlemidir	Onlem/i/dir
Onlemlerde	Onlem/ler/de
gOrUStUklerini	gOr/US/tUk/ler/in/i
aCIklamalarIdIr	aCIk/la/ma/lar/I/dIr
sUrdUrenleri	sUr/dUr/en/ler/i
sergilerine	ser/gi/ler/i/ne
oluSturmalarI	oluS/tur/ma/lar/I
getirenlerin	getir/en/ler/in
denediklerini	dene/dik/ler/i/ni
gOrgUlerini	gOr/gU/ler/i/ni
mUkelleflerinden	mUkellef/ler/in/den
marklarIn	mark/lar/In
vatandaSlarIn	vatandaS/lar/In
kusurlarIn	kusur/lar/In
haydutlarIn	haydut/lar/In
geliStirmedikleri	geliS/tir/me/dik/ler/i
eldivenlerle	eldiven/ler/le
derslerle	ders/ler/le
hatlarIn	hat/lar/In
buldozerlerle	buldozer/ler/le
ilimlerle	ilim/ler/le
fragmanlarIn	fragman/lar/In
bulutlarIn	bulut/lar/In
parlamentolarIn	parlamento/lar/In
umutlarIn	umut/lar/In
nedenlerine	neden/ler/in/e
fUzelerine	fUze/ler/in/e
bildirgelerle	bildirge/ler/le
sUrprizlerinden	sUrpriz/ler/in/den
astlarIn	ast/lar/In
sIralarIn	sIra/lar/In
hIzlarIn	hIz/lar/In
objelerle	obje/ler/le
tOrenlerle	tOren/ler/le
mUslUmanlarIn	mUslUman/lar/In
haClarIn	haC/lar/In
anlatabilmeleri	an/lat/abil/me/ler/i
UrUnlerle	UrUn/ler/le
genCliklerini	genC/lik/ler/i/ni
In	I/n
kazanmalarInI	kazan/ma/lar/I/nI
genCliklerinin	genC/lik/ler/in/in
taksidi	taksid/i
sahili	sahil/i
garibi	garib/i
lifi	lif/i
konsepti	konsept/i
verniGi	verniG/i
COmleGi	COmleG/i
tuvali	tuval/i
koliti	kolit/i
maili	mail/i
beSiGi	beSiG/i
polemiGi	polemiG/i
meltemi	meltem/i
iSlemelerle	iSle/me/ler/le
gOllerinde	gOl/ler/in/de
hasreti	hasret/i
icmali	icmal/i
otellerinde	otel/ler/in/de
baleti	balet/i
erkeGi	erkeG/i
fatihi	fatih/i
moderni	modern/i
maddelerdir	madde/ler/dir
bulunabilmelerini	bul/un/abil/me/ler/in/i
boyanmalarI	boya/n/ma/lar/I
tIrlar	tIr/lar
daGIlmalar	daGIl/ma/lar
semtini	semt/in/i
plaketini	plaket/in/i
vekilini	vekil/in/i
torunlarInI	torun/lar/In/I
talimatlarInI	talimat/lar/In/I
geCmedikleri	geC/me/dik/ler/i
astlarInI	ast/lar/In/I
verilerinizi	veri/ler/iniz/i
fikirlerinizi	fikir/ler/iniz/i
sahalarI	saha/lar/I
kaGanlarI	kaGan/lar/I
rotalarI	rota/lar/I
kopyalarI	kopya/lar/I
kalfalarI	kalfa/lar/I
SaftlarI	Saft/lar/I
hissettiklerini	hisset/tik/ler/in/i
parolalarI	parola/lar/I
Seflerinden	Sef/ler/i/nden
iSlemelerinin	iSle/me/ler/i/nin
Sairlerinden	Sair/ler/i/nden
nikahlarI	nikah/lar/I
dergahlarI	dergah/lar/I
saatlerinden	saat/ler/i/nden
dikkatlerinin	dikkat/ler/i/nin
nahiyelerinde	nahiye/ler/i/nde
tercihlerinde	tercih/ler/i/nde
abonelikleri	abone/lik/ler/i
kelimeleriyle	kelime/ler/i/yle
teSvikleriyle	teSvik/ler/i/yle
tecrUbeleriyle	tecrUbe/ler/i/yle
sUvarileriyle	sUvari/ler/i/yle
mUzisyenleriyle	mUzisyen/ler/i/yle
illerle	il/ler/le
azizler	aziz/ler
fetihler	fetih/ler
adeleler	adele/ler
dUnler	dUn/ler
rakipler	rakip/ler
payeler	paye/ler
OveCler	OveC/ler
menUler	menU/ler
mUdahaleler	mUdahale/ler
doktrinler	doktrin/ler
UCUncUler	UCUncU/ler
ihtilaller	ihtilal/ler
solistler	solist/ler
verebilmelerini	ver/ebil/me/ler/in/i
gidiSlerine	gidiS/ler/i/ne
derecelerine	derece/ler/i/ne
aboneler	abone/ler
entariler	entari/ler
keSfetmelerini	keSfet/me/ler/i/ni
uyarlamalarI	uyarla/ma/lar/I
birlerine	bir/ler/i/ne
inanmalarI	inan/ma/lar/I
aramalarI	ara/ma/lar/I
tesadUflerin	tesadUf/ler/in
mimiklerin	mimik/ler/in
iSaretlerin	iSaret/ler/in
minerallerin	mineral/ler/in
dUSUnUrlerin	dUSUnUr/ler/in
etkenlerin	etken/ler/in
fenerlerin	fener/ler/in
simitlerin	simit/ler/in
zihniyetlerin	zihniyet/ler/in
Universitelerin	Universite/ler/in
haller	hal/ler
Odentilerin	Odenti/ler/in
meltemlerin	meltem/ler/in
sandalyelerini	sandalye/ler/i/ni
sakinlerini	sakin/ler/i/ni
hazinelerini	hazine/ler/i/ni
gazetelerin	gazete/ler/in
krokilerinin	kroki/ler/in/in
hisselerini	hisse/ler/i/ni
kalemlerinin	kalem/ler/in/in
Odentilerinin	Odenti/ler/in/in
eGitimlerini	eGit/im/ler/in/i
Onlemlerinin	Onlem/ler/in/in
inanmamalarI	inan/ma/ma/lar/I
hainidirler	hain/i/dir/ler
serilerini	seri/ler/in/i
primlerini	prim/ler/in/i
kapasitelerini	kapasite/ler/in/i
iller	il/ler
figUrleri	figUr/ler/i
teknolojileri	teknoloji/ler/i
apoletleri	apolet/ler/i
akrepleri	akrep/ler/i
mUminleri	mUmin/ler/i
Onderleri	Onder/ler/i
emsalleri	emsal/ler/i
penCeleri	penCe/ler/i
manileri	mani/ler/i
mahalleri	mahal/ler/i
kOleleri	kOle/ler/i
icmalleri	icmal/ler/i
depremleri	deprem/ler/i
hisseleri	hisse/ler/i
trajedileri	trajedi/ler/i
sahipleridirler	sahip/ler/i/dir/ler
