nassa	nassa
ɨlʼlʼe	ɨlʼlʼe
meːltɨqam	meːltɨ/qam
wättɨ	wättɨ
ompä	ompä
məːta	məːta
puːlʼa	puːlʼa
uːčʼa	uːčʼa
tanta	tanta
kotqo	kotqo
säːppɨlʼak	säːppɨlʼak
qəəəə	qəəəə
ontä	ontä
alʼčʼa	alʼčʼa
qaqa	qaqa
tıːrɨ	tıːrɨ
jeːsʼa	jeːsʼa
maːčʼo	maːčʼo
Mat	Mat
taštɨ	taštɨ
ɛh	ɛh
qaje	qaje
tolʼkə	tolʼkə
seːpɨlʼak	seːpɨlʼak
qəːš	qəːš
qas	qas
moːttattätɨ	moːttattätɨ
poːs	poːs
načʼe	načʼe
imɨlʼa	imɨlʼa
məːša	məːša
šäkka	šäkka
olla	olla
olɨ	olɨ
puraaa	puraaa
ɨnna	ɨnna
čʼäːp	čʼäːp
nu	nu
nɔːkɨr	nɔːkɨr
polla	polla
čʼapqaš	čʼapqaš
čʼeːlʼtätɨlʼ	čʼeːlʼtätɨlʼ
tottɨŋɨlit	tottɨ/ŋɨlit
seːpɨlak	seːpɨlak
tümɨ	tümɨ
sepelak	sepelak
košinamɨt	košinamɨt
sämnälʼä	sämnälʼä
muntɨ	muntɨ
šip	šip
kɨpa	kɨpa
kotqɨlʼlʼe	kotqɨlʼlʼe
qontortɨ	qontortɨ
mun	mun
čʼiːtɨ	čʼiːtɨ
təttɨ	təttɨ
naš	naš
čʼaptät	čʼaptät
ətɨmɨntɨ	ətɨmɨntɨ
kanakɨntɨ	kana/kɨntɨ
ɨːrɨŋ	ɨːrɨŋ
možet	možet
säː	säː
nännɨ	nännɨ
okon	okon
qai	qai
üntinimtɨje	ünti/nimtɨje
šitämteːlʼi	šitä/mteːlʼi
qaːla	qaːla
kulʼ	kulʼ
šelʼqup	šelʼqup
tiː	tiː
pɛltimenan	pɛlti/menan
kuli	kuli
toːta	toːta
tɨntalʼ	tɨntalʼ
čʼam	čʼam
tɛːttɨ	tɛːttɨ
kɨka	kɨka
torqɨ	torqɨ
lʼipɨ	lʼipɨ
aš	aš
kušaj	kušaj
teːmtɨ	teːmtɨ
ont	ont
qontartɨ	qontartɨ
kusa	kusa
kunä	kunä
čʼəːsɨ	čʼəːsɨ
šekkɨ	šekkɨ
miːtɨ	miːtɨ
kotɨk	kotɨk
nʼännä	nʼännä
meːlt	meːlt
ılle	ılle
qapija	qapija
čʼarɨp	čʼarɨp
üːta	üːta
kontɨ	kontɨ
šinet	šinet
qɨr	qɨr
namɨša	namɨša
pɨːpa	pɨːpa
čʼäp	čʼäp
melʼtɨ	melʼtɨ
tiːntäna	tiːntäna
qotta	qotta
čʼiːrɨ	čʼiːrɨ
tona	tona
uže	uže
sɨrɨ	sɨrɨ
me	me
oš	oš
onɨt	onɨt
ontɨn	ontɨn
Loːsɨ	Loːsɨ
kušat	kušat
qajes	qajes
mɨtta	mɨtta
qatamol	qatamol
najɛnta	najɛnta
qanɨkɨt	qanɨ/kɨt
moqɨnɨ	moqɨnɨ
nɨnä	nɨnä
tɨːnɨ	tɨːnɨ
porä	porä
imnʼassɨkkej	imnʼa/ssɨ/kkej
uːquːquː	uːquːquː
qara	qara
uquuu	uquuu
nʼiːrɨlʼ	nʼiːrɨlʼ
paldʼülʼewlə	paldʼü/lʼewlə
nild	nild
tʼаŋоndə	tʼаŋо/ndə
а	а
nʼanno	nʼanno
aaaaa	aaaaa
leːpä	leːpä
qal	qal
šɨndə	šɨndə
tintäna	tintäna
qɔːtɨ	qɔːtɨ
naːtnо	naːtnо
təːka	təːka
šuː	šuː
šelqup	šelqup
täːto	täːto
seːp	seːp
qɔːt	qɔːt
qəə	qəə
lʼos	lʼos
man	man
tɨntɨna	tɨntɨna
topɨti	topɨ/ti
ras	ras
tep	tep
qälɨporɨ	qälɨ/porɨ
tišä	tišä
əːtɨmɨntɨ	əːtɨmɨntɨ
moːrɨ	moːrɨ
mɨka	mɨka
İlʼčʼa	İlʼčʼa
čʼoj	čʼoj
rakšältättɨ	rakš/ält/ättɨ
čʼarɨqalɔːqɨ	čʼarɨ/qa/lɔːqɨ
ɨlqɨnɨ	ɨl/qɨnɨ
tɔːpɨqɨnɨ	tɔːpɨ/qɨnɨ
čʼeːlatta	čʼeːla/tta
čʼaŋkɨmä	čʼaŋkɨ/mä
