gOkyUzUyle	gOkyUzU/yle
metindi	metin/di
gerekCeyle	gerekCe/yle
sevecenlik	sevecen/lik
ararIm	ara/r/Im
veritabanlarIyla	veritaban/larI/yla
unvanlarIyla	unvan/larI/yla
edebiyatImIz	edebiyat/Im/Iz
kemoterapiye	kemoterapi/ye
meteorolojiye	meteoroloji/ye
huriye	huri/ye
muayenehaneye	muayenehane/ye
yeltendi	yelten/di
darUlacezeye	darUlaceze/ye
cahiliz	cahil/iz
olunmaz	ol/un/maz
tanItIyorum	tan/It/Iyor/um
CalISIyorum	CalIS/Iyor/um
tUrUdUr	tUr/U/dUr
kadardI	kad/ar/dI
yargIdIr	yar/gI/dIr
adaletsizlik	adalet/siz/lik
bulsanIz	bul/sa/nIz
aklInIz	ak/lI/nIz
modernleSmeden	modern/leS/meden
iSletiyordu	iS/let/iyor/du
gOstermekteyiz	gOster/mek/te/yiz
imparatorluklarInI	imparator/luk/larI/nI
ayIrIrsak	ayIr/Ir/sa/k
sOyleyemeyeceGim	sOyle/yeme/yeceG/im
yargItayImIz	yargItay/Im/Iz
filomuz	filo/m/uz
tiyatrosuna	tiyatro/su/na
bUromuz	bUro/m/uz
tUrUnU	tUr/Un/U
balkonundan	balkon/u/ndan
krediye	kredi/ye
mUdafiye	mUdafi/ye
aGIrlaStIrarak	aGIr/laS/tIr/arak
aceleye	acele/ye
falI	fa/lI
dOnUlecekti	dOn/Ul/ecek/ti
sakallI	sakal/lI
malatyalI	malatya/lI
uzlaSarak	uz/laS/arak
birleSmeli	bir/leS/meli
doGmazdI	doG/maz/dI
konuSturdum	konuS/tur/du/m
okuduGumu	oku/duG/um/u
anlIyormuSum	an/lIyor/muS/um
temelsizdi	temel/siz/di
dinsizlik	din/siz/lik
Uredi	Ure/di
aSkIm	aSk/Im
keSfedeceGimiz	keSfed/eceG/imiz
sayardI	say/ar/dI
sorununun	sorun/un/un
ambarlI	ambar/lI
devSiren	devSir/en
sakInIm	sakIn/Im
kUlahlI	kUlah/lI
aboneye	abone/ye
gerCekleSemeyecek	gerCek/leS/eme/yecek
atlIya	at/lI/ya
gerilimden	geri/lim/den
tanIStIracak	tan/IS/tIr/acak
baSaramazsam	baSar/amaz/sa/m
korkmaktadIr	kork/mak/ta/dIr
nikahlI	nikah/lI
saklI	sak/lI
passionu	passion/u
hatunu	hatun/u
eleStirim	eleStiri/m
olmuSumdur	ol/muS/um/dur
devletlim	devletli/m
sendromu	sendrom/u
aGlI	aG/lI
pozisyonu	pozisyon/u
sempozyumu	sempozyum/u
kuruluSunuzda	kur/ul/uS/unuz/da
CakmIStI	Cak/mIS/tI
patlamIStI	patla/mIS/tI
kIsItlIlIk	kIsIt/lI/lIk
karSIlaStIrInIz	karSI/laS/tIr/InIz
yapabilmekteydi	yap/abil/mekte/ydi
arayanlarInda	ara/yan/larI/nda
kurulamamIStI	kurul/ama/mIS/tI
girdim	girdi/m
sunumu	sunum/u
aktarabiliyorsunuz	aktar/abil/iyor/sunuz
pantolonuyla	pantolon/u/yla
uyanIrdIk	uyan/Ir/dI/k
halletmek	hal/let/mek
barIndIrIyordu	barIn/dIr/Iyor/du
dolaSIyorsa	do/laS/Iyor/sa
edebiliyoruz	ed/ebil/iyor/uz
durdurulmuS	dur/dur/ul/muS
yatIrIldIktan	yatIr/Il/dIk/tan
sIkIStIrIlIp	sIk/IS/tIr/Il/Ip
koSuttur	koS/ut/t/ur
yaSantIm	yaSantI/m
kompozisyonu	kompozisyon/u
arzum	arzu/m
oradayken	ora/da/yken
unsurlarIna	unsur/larI/na
seyrettim	seyret/ti/m
gerCekleSmez	gerCek/leS/mez
diliyor	di/l/iyor
saatleriydi	saat/leri/ydi
fragmanlarIna	fragman/larI/na
konuGumu	konuG/um/u
uzvunu	uzv/un/u
toplusOzleSmeli	toplusOzleSme/li
susadI	susa/dI
armaGanmIS	armaGan/mIS
kompozisyonudur	kompozisyon/u/dur
karakeCili	karakeCi/li
mineli	mine/li
bununki	bu/nun/ki
bedenli	beden/li
devrilebilecek	devril/ebil/ecek
gidebiliyor	gid/ebil/iyor
tenteli	tente/li
sorununu	sorun/un/u
uGradIk	uGra/dI/k
gerektirip	gerek/tir/ip
yaSantIlarIna	yaSantI/larI/na
kIvrImlarInI	kIvrIm/larI/nI
dUSUnUSe	dUSUn/US/e
uzamIS	uza/mIS
asitli	asit/li
Ulkeli	Ulke/li
dekardIr	dekar/dIr
tavdIr	tav/dIr
bitirmiStik	bitir/miS/ti/k
aSkIndIr	aSkIn/dIr
kompozisyonlarInda	kompozisyon/larI/nda
buluverir	bul/uver/ir
algIlanmIyor	al/gI/lan/mIyor
kazandIysam	kazan/dI/ysa/m
bulsaydIm	bul/sa/ydI/m
gOrUlmekten	gOr/Ul/mek/ten
taslaktaki	taslak/ta/ki
sInavdIr	sInav/dIr
CatIlIr	Cat/Il/Ir
yUksekli	yUksek/li
taramIS	tara/mIS
konuSunda	kon/uS/u/nda
getireceGiz	getir/eceG/iz
yerdim	yer/di/m
sUrprizli	sUrpriz/li
piSmiS	piS/miS
yargItaydIr	yargItay/dIr
durdurduGuna	dur/dur/duG/u/na
UremiSti	Ure/miS/ti
hazIrlanmadan	hazIr/lan/madan
yankIlaSIm	yankI/laS/Im
mUzisyenlerinden	mUzisyen/leri/nden
giriSimcilik	gir/iS/im/ci/lik
birlikleri	birlik/leri
dUSeceGiz	dUS/eceG/iz
bOlUmleri	bOlUm/leri
deGinilmekte	deGin/il/mekte
seCmenleri	seCmen/leri
demokrasileri	demokrasi/leri
Cizgiden	Ciz/gi/den
kOkenleri	kOken/leri
tUrkiyeli	tUrkiye/li
bireyleri	birey/leri
