sUmbUl	sUmbUl
lavrion	lavrion
lavman	lavman
kUnefe	kUnefe
kendir	kendir
somut	somut
kardiyak	kardiyak
titreyerek	titre/yerek
endoderm	endoderm
sarICam	sarICam
uCak	uCak
antarktik	antarktik
soyucu	soy/ucu
sIhhIye	sIhhIye
semih	semih
UnaydIn	UnaydIn
ensest	ensest
karamsar	karamsar
adler	adler
okSasIn	okSa/sIn
defaten	defaten
mUSahit	mUSahit
aGustos	aGustos
mansIz	mansIz
tedmer	tedmer
mazur	mazur
letafet	letafet
literatUr	literatUr
mUstacel	mUstacel
meSgulsUnUz	meSgul/sUnUz
sUnger	sUnger
muarrem	muarrem
gUdU	gUdU
sabotaj	sabotaj
OdUnC	OdUnC
gabari	gabari
doyur	doyur
vakanUvis	vakanUvis
rezerv	rezerv
turcas	turcas
trombon	trombon
iyodUr	iyodUr
duo	duo
pestil	pestil
bedensel	bedensel
hot	hot
tUmen	tUmen
pas	pas
karyaGdI	karyaGdI
kontra	kontra
efsanevi	efsanevi
pedikUr	pedikUr
duyusal	duyusal
pazI	pazI
neSriyat	neSriyat
taSkent	taSkent
plus	plus
konyaspor	konyaspor
cimbom	cimbom
semantik	semantik
asetilen	asetilen
derebeyi	derebeyi
kulUbecik	kulUbe/cik
korkunC	korkunC
sullivan	sullivan
halis	halis
baSlIbaSIna	baSlIbaSIna
Unite	Unite
yetkin	yetkin
CeaS	CeaS
yumuSakCa	yumuSakCa
dinsel	dinsel
pavurya	pavurya
monitOrlUk	monitOr/lUk
saldIrgan	saldIrgan
iCkin	iCkin
acele	acele
kOle	kOle
ambar	ambar
ibo	ibo
ayet	ayet
gavur	gavur
gavurca	gavur/ca
UCUncUsUnUn	UCUncU/sU/nUn
kesinti	kesinti
millet	millet
canbaz	canbaz
susa	susa
meditasyon	meditasyon
buGu	buGu
doGurgan	doGurgan
gOtUrUcU	gOtUr/UcU
gUlUmsUyor	gUlUms/Uyor
orospuluk	orospu/luk
kOSklU	kOSk/lU
dinleyip	dinle/yip
gOrUyUm	gOrU/yUm
terkedince	terked/ince
Cizgim	Ciz/gim
yokluk	yok/luk
seCemiyor	seC/emiyor
emanetCi	emanet/Ci
gOrUsUnU	gOrU/sU/nU
Odeyemezler	Ode/yeme/zler
arzuluyorsunuz	arzu/luyor/sunuz
OtUSUp	Ot/US/Up
entari	entari
irdeleyin	irdele/yin
kIlavuzlu	kIlavuz/lu
kasabamIz	kasaba/mIz
istemem	iste/mem
durak	durak
indirgeyici	indirge/yici
kodlu	kod/lu
atardamar	atardamar
Oylesin	Oyle/sin
ibonun	ibo/nun
gOlgeyi	gOlge/yi
obje	obje
adliyeyi	adliye/yi
ocaksIz	ocak/sIz
balet	balet
buGunun	buGu/nun
tempoyu	tempo/yu
aSIyI	aSI/yI
baSvurunuz	baSvuru/nuz
dISsatImcI	dISsatIm/cI
baSvuruyu	baSvuru/yu
adaletCi	adalet/Ci
besteyi	beste/yi
maGlupken	maGlup/ken
bedavacI	bedava/cI
atsInlar	at/sInlar
pantolonlu	pantolon/lu
yatIrarak	yatIr/arak
rUyamIz	rUya/mIz
parCacI	parCa/cI
Onemsemeli	Onemse/meli
gerekmez	gerek/mez
gOzUkUr	gOzUk/Ur
haC	haC
krediniz	kredi/niz
gOmUlmUStU	gOm/Ul/mUS/tU
dinleyecek	dinle/yecek
aSmamIz	aS/mam/Iz
okuyamayan	oku/yama/yan
okutuyoruz	ok/ut/uyor/uz
mahvettikten	mahvet/tik/ten
arsIzca	ar/sIz/ca
kasetten	kaset/ten
kanmaz	kan/maz
mucizeydi	mucize/ydi
hekimce	hekim/ce
anketten	anket/ten
bakman	bak/man
giderek	gid/erek
yazInIz	yazI/nIz
vazgeCerek	vazgeC/erek
keSfettikten	keSfet/tik/ten
konuStunuz	kon/uS/tu/nuz
ameliyatta	ameliyat/ta
kaSIkta	kaSIk/ta
kIrmIzIya	kIrmIzI/ya
sIkmaz	sIk/maz
kOpekten	kOpek/ten
ambargoya	ambargo/ya
gerekmiyor	gerek/miyor
odaya	oda/ya
milletce	millet/ce
