slough	slough
putrefy	putrefy
giant	giant
teasel	teasel
caddie	caddie
geese	geese
plaice	plaice
contempt	contempt
tangible	tangible
lye	lye
machismo	machismo
tangle	tangle
malnutrition	mal/nutrition
frolicsome	frolic/some
frivolous	frivolous
surgeon	surgeon
referendum	referendum
biceps	biceps
industry	industry
sucrose	sucrose
stream	stream
strode	strode
flambeau	flambeau
fled	fled
temper	temper
sturdy	sturdy
oboe	oboe
malversation	malversation
maltster	malt/ster
omnivorous	omnivorous
regalia	regalia
frisian	frisian
region	region
strung	strung
grandad	gran/dad
forbidden	forbidden
chigger	chigger
wary	wary
pizza	pizza
derogate	derogate
hew	hew
describe	describe
zodiac	zodiac
tract	tract
purport	purport
heron	heron
discipline	discipline
venezuela	venezuela
pellet	pellet
codeine	codeine
heap	heap
physiognomy	physiognomy
cognate	cognate
griffon	griffon
ravine	ravine
bit	bit
tete-a-tete	tete-a-tete
thematic	them/atic
fauna	fauna
tenable	tenable
theodolite	theodolite
linden	linden
quixote	quixote
tut	tut
commingle	com/mingle
collapse	col/lapse
bite	bite
precarious	precarious
coolie	coolie
pled	pled
cornstarch	corn/starch
muscovy	muscovy
date	date
numismatic	numismatic
plenitude	plenitude
plight	plight
rowanberry	rowan/berry
silo	silo
mitigate	mitigate
eaves	eaves
sforzandi	sforzandi
seychellois	seychellois
rococo	rococo
nasal	nasal
battery	battery
dubbin	dubbin
remunerate	remunerate
seize	seize
pupa	pupa
sanitaria	sanitaria
rat-a-tat-tat	rat-a-tat-tat
scullion	scullion
se	se
reduce	reduce
sleazy	sleazy
dissolute	dissolute
divorcee	divorc/ee
derv	derv
post-mortem	post-mortem
popinjay	popinjay
mosque	mosque
sabah	sabah
prod	prod
sang	sang
danny	danny
scribble	scribble
beheld	beheld
mascot	mascot
ferment	ferment
sterna	sterna
skirl	skirl
manicure	manicure
fawn	fawn
nostalgia	nostalgia
sodium	sod/ium
crematoria	cremat/oria
sped	sped
isolate	isolate
corvette	corvette
nut	nut
snap	snap
treasure	treasure
mediterranean	mediterranean
fairyland	fairy/land
carpetbagger	carpetbagger
cuticle	cuticle
midsummer	mid/summer
sensitive	sensitive
exit	exit
settle	settle
starkers	starkers
sou	sou
culprit	culprit
stable	stable
stalwart	stalwart
crow	crow
non-profit-making	non-profit-making
revere	revere
revolt	revolt
punic	punic
gladiator	gladiator
propjet	prop/jet
analyst	anal/yst
ampere	ampere
hydroponic	hydroponic
chancellor	chancellor
cathode	cathode
baccalaureate	baccalaureate
anorexia	anorexia
prophesy	prophesy
chauvinism	chauvinism
psyche	psyche
lachrymose	lachrymose
worse	worse
aides-memoire	aides-memoire
impregnable	impregnable
pullman	pullman
pieta	pieta
anatomy	anatomy
park	park
knesset	knesset
idem	idem
incipient	incipient
antenna	antenna
celery	celery
aureola	aureola
prognoses	prognoses
catastrophe	catastrophe
abrogate	abrogate
